11111111111111111111111111111111
11111111111111111111111111111111
10000000L00100000000011111111111
11011111L01000000000011111111111
11000000L01011100111011111111111
11001110L00001110110011111011111
11000000L01000000000011000001111
10000000L11000000000001000001111
1000000D011000000110000000001111
11111111000011100111000000000111
11111111111110000001111111111111
11111111111100000000111111111111
10000000000000000000110000000001
10000000000001111100000000000001
10000000000000000L00001110011101
10000000000000000L11100111011001
10000000000110000L11100000000001
10000000000111000L00000000000001
10000000000000000100000000011001
11111001111011101110001110011101
11111111111111111111111000000111
11111111111111111111111100000111
10000000000000000000111100000011
100L0000000000100000011000000001
111L1100001111111000100001111101
111L1100001111100001100000111001
111L1100000011000011101000000001
111L11000000000010000010E0011001
101L1101100000001000011110110001
100L0001100011111100011110000101
11111111111111111111111111111111
11111111111111111111111111111111
