11111111111111111111111111111111
11111111111111111111111111111111
10000000000111000000011111111111
10111001110110000000011111111111
1011111100011000LD11111111111111
1011111000000000L111111111011111
1001000000000000L111111000001111
1010000000001100L001101000001111
10101100000111111111100000001111
10001000001000111000100000000111
11111000001111111111111111111111
10000000000111111111111111111111
10000000000000000000000000000001
1000000000000L000000001110011101
1110000000011L110000101111110001
111L000000011L110000101111100001
111L111111011L110000000100000001
100L000001011L110000001000000001
110L111100101L110110001011000001
110L000000100L000110000010000011
11111111111111111111111110000011
11111111111111000011100000000001
100000000000000000L0000000000001
100000000001011111L0100000000001
100000000001000000L0111000000001
100000000001001110L0011L00000001
100000000001000000L0111L11111101
100000000000000000L1100L00000101
1000000000000E000001110L11110011
11111001111111111100010L00000011
11111111111111111111111111111111
11111111111111111111111111111111
