11111111111111111111111111111111
11111111111111111111111111111111
10000000000000111000000000000011
10000000000000000011000010000001
10000000000000000111111111100001
10000000000000000000011110000111
10000000000000000000001100001111
10000000000000011001000000000001
1000000000000001D001000001100001
11111001111111111111101000000001
11111111111111111111111000000111
11111111111111111111110000000011
10000000001000000000000000000011
1000100000000L000000000111110001
1111111000011L1100001000000L0001
1111100001111L1100001000000L1111
1011000011111L1100000110000L1111
1000000000011L1100000111000L0001
1000011000001L110110000000010001
1010000000000L000110001110111001
11100000011111111111111111111111
10000000000111000011100000011111
100000000000000000L0001111001111
100000000001011111L0100000000001
111000000001000000L0100011111001
111L00000001001110L0000000000001
111L11111101000000L0111100001001
100L00000100000000L1111110011001
110L111100100E000001100100111001
110L0000001111111100000000000001
11111111111111111111111111111111
11111111111111111111111111111111
