11111111111111111111111111111111
11110000000111111111111111111111
11110010000000000000000000000001
1100011110000L000000001110011101
1100000000011L110000101111110001
1100000101111L110000101111100001
100000L10D111L110000000100000001
111111L111111L110000001000000001
100011L111101L110110001011000001
100000L001100L000110000010000011
11111111111111111111111110000011
11111111111111111111100000000001
10000000000000000000100000000001
10000000000000100000000000000001
10000000000111111000011000000001
10000000000111100001111L00000001
10000000000011000011111L11111101
10000000000000000000000L00000101
10000000000000011000010L11110011
11111001111010000000010L00000011
11111111111110000001111111111111
10000001111111000001111111111111
10011000111111000000111111111111
1000000000L110000000011111111111
1000000011L000011111011111111111
1011110011L000001110011111011111
1000000011L010000000011000001111
1000000011L010E00110001000001111
1000011111L111101100000000001111
1111000000L111100001000000000111
11111111111111111111111111111111
11111111111111111111111111111111
