11111111111111111111111111111111
11111111111111000011111111111111
10001110000110000001000000000011
10000000110010000000000010000001
1000000111100L0000L0011111100001
1000000000000L1111L0011110000111
1000000000000L0000L0001100001111
1000011001000L1111L0100000000001
100001D001000L1111L0100001100001
1111111111110L1110L0001000000001
11111111111111111111111000000111
11111111111111111111111000000001
10L01000000L00000000010000000001
11L11000000L11111110011000001111
11L00000000L00000000000000000001
10L00000000L00000110000000000L01
10L00000000L00000111001111111L01
10L00001000L00010000001000111L01
11110001111L11010000011000110L01
11000000001111111000010000000011
11110000011111111111111111111111
11000000001111111111100110011101
10000000000000000000000000001001
1000100000000L000000011111101111
1000000000011L110000101000000001
1011100001111L110000100000111111
1011000001111L110000000000000001
1000000000011L110000000001000001
1000011000001L110110000011000001
1000000010000L00011000011111E011
11111111111111111111111111111111
11111111111111111111111111111111
