11111111111111111111111111111111
11111111111000000111111111111111
10000000000001100011100011100001
11110111111000000000L00000001101
11010111111000000011L00000011111
10000000111011110011L00000000001
10000000011000000011L00000000001
10000000000000000011L00001100101
10110000000000011111L00001D00101
11100000011111000000L11111111111
11111100011111111111111111111111
11000000001000000111111111111111
10000000000001100011110000000001
10001000000000000000L00000000001
10000000000000000011L01110011101
10111000011011110011L00111011001
10110000011000000011L00000000001
10000000000000000011L00000000001
10000110000000011111L00000011001
10000000100111000000L01110011101
11111111111111111111111000000111
11111111111000000000011000000001
10000000000000000000010000000001
10000000000000000000011000001111
10000000000001001111000000000001
10000000000001001111000000000L01
10000000000001001111001111111L01
100000000000E1101111001000111L01
10000000000111000000011000110L01
11111001111111111111010000000011
11111111111111111111111111111111
11111111111111111111111111111111
