11111111111111111111111111111111
11110000000111111111100000000001
11110010000100000000000000011001
11000111100000000000010001L01001
11000000000011100111000000L00001
11000001011001110110000000L11001
100000L10D1000000000001110L11001
111111L1111000000000001010L11001
100011L1111000000110000000011111
100000L0011011100111000000011011
11111111111110000001111111111111
11111111111100000000111111111111
11111111111000000000010000000001
11111111111000100000000000000001
11111111111000000000001110011101
11111011111011100001100111011001
11110000011011000001100000000001
11110000010000000000000000000001
11110000000000011000000000011001
11100000000000000010001110011101
11111111111111111111111000000111
11111111111111000001111000000001
10000000000001100001010000000001
10000000000000110000011000001111
10000000000010000111000000000001
10000000000011111111000000000L01
10000000000001100000001111111L01
10000000000000000000001000111L01
10000000000000110010011000110L01
1111100111100011E110010000000011
11111111111111111111111111111111
11111111111111111111111111111111
