11111111111111111111111111111111
11110000000111111111111111111111
11110010000L00000000010000000001
11000111100L11111110000000000001
11000000000L00000000001110011101
11000001011L00000110000111011001
100000L10D1L00000111000000000001
111111L1111L00010000000000000001
100011L1111L11010000000000011001
100000L0011111111000001110011101
11111111111111111111111000000111
11111111111111000011100000000001
11000000000110000001000000000001
10000000000010000000000000000001
1011100111000L0000L0011000000001
1001110110000L1111L0011L00000001
1000000000000L0000L0011L11111101
1000000000000L1111L0100L00000101
1000000110000L1111L0110L11110011
1011100111010L1110L0010L00000011
11100000011111111111111111111111
11000000001000000000011111111111
10110000001000000000000000000001
101100L0000000000000000L00000001
101111L0000001001111011L11000011
100000L0001001001111011L11000011
100111L0001001001111011L11000001
100000L00000E1101111011L11000001
100000L1110111000000001L11011001
100000L1000111111111000L00011001
11111111111111111111111111111111
11111111111111111111111111111111
