11111111111111111111111111111111
11111111111000000111111100000001
10000000000001100011111100100001
11110111111000000000L10001111001
11010111111000000011L10000000001
10000000111011110011L10000010111
10000000011000000011L00000L10D11
10000000000000000011L11111L11111
10110000000000011111L00011L11111
11100000011111000000L00000L00111
11111100011111111111111111111111
11100000000111111111111111111111
11000000000000000000000000000001
1110000011100L000000001110011101
1000000000011L110000101111110001
100000000L011L110000101111100001
101111111L011L110000000100000001
101000111L011L110000001000000001
111000110L001L110110001011000001
1100000000100L000110000010000011
11111111111111111111111110000011
11111111111111000001110000000011
10000000000111000000100000000001
10000000000110000000000010000001
10000000000000011111000000000001
10000000000000001110001110000111
10000000000010000000001100000111
10000000000010E00110000000000001
10000000000111101100000001100001
11111001111111100001000000001001
11111111111111111111111111111111
11111111111111111111111111111111
