11111111111111111111111111111111
11111111111111000011111101111101
10000000000110000001011100010001
10111001110010000000000000000001
1011111100000L0000L0000000000001
1011111000000L1111L0000000000001
1001000000000L0000L0000000000001
1010000000000L1111L0100001100101
1010110000000L1111L0100001D00101
1000100000110L1110L0001111111101
11111000001111111111111111111111
11000000001111111111111111111111
10000000000000000000010000000001
1000100000000L000000000000000001
1000000000011L110000101110011101
1011100001111L110000100111011001
1011000001111L110000000000000001
1000000000011L110000000000000001
1000011000001L110110000000011001
1000000010000L000110001110011101
11111111111111111111111000000111
11111111111000000111100000000001
1L000000000011110011100000000001
1L111111100000000000000000000001
1L000000000000111110000100111101
1L000001100000000000000100111101
1L000001110111000010000100111101
1L00010000011110011000E110111101
1L110100000001001110011100000001
11111110000000000000011111111101
11111111111111111111111111111111
11111111111111111111111111111111
