11111111111111111111111111111111
11111111111111111111111101111101
11000000000000000000111100010001
10000000000000100000000000000001
10111001110111111000100000000001
10011101100111100001100000000001
10000000000011000011100000000001
10000000000000001000000001100101
10000001100000001000000001D00101
10111001110011111100001111111101
11100000011111111111111111111111
11000000001111111111111111111111
10110000001000000000000000000001
101100L000000L000000011101111111
101111L000011L110000110101111111
100000L000111L110000100000001111
100111L000111L110000000000000111
100000L000011L110000000000000001
100000L111001L110110001100000001
100000L100000L000110011000000111
11111111111111111111111111000111
11111111111111000001101111000011
1L000000000111000000100010000111
1L111111100110000000000000000001
1L00000000000001111100L000000001
1L00000110000000111000L111110001
1L00000111001000000000L000010001
1L000100000010E0011000L011011001
1L11010000011110110000L111001101
11111110000111100001011111111101
11111111111111111111110001111111
11111111111111111111111111111111
