11111111111111111111111111111111
11111111111111111111111111111111
11110000000100000000010000111111
11100000000000000000010000011011
111000LD111011100111010000001011
100000L1111001110110010000000011
100000L1111000000000010000000011
101100L0011000000000000000000001
11111111111000000110000111010011
10001110001011100111001111110111
11111111111110000001111111111111
11111111111000000000011111111111
10000000001000000000011111111111
10001000000000000000011111111111
11111110000110000000011111111111
1111100001111L000000011111011111
1011000011111L111111011000001111
1000000000000L000001001000001111
1000011000010L111100100000001111
1010000000010L000000100000000111
11100000011111111111111111111111
11110000011000000111111111111111
11110000001001100011100000000001
11100000000000000000L00000000001
10000111110000000011L00000000001
10000011100011110011L00000000001
10100000000000000011L00000000001
1010E001100000000011L00000000001
11111011000000011111L00000000001
11111000010111000000L11110011111
11111111111111111111111111111111
11111111111111111111111111111111
