11111111111111111111111111111111
11110111110111111111111111111111
11110001000000000000100000000001
10000000000000100000011101111111
10000000000111111000110101111111
10000000000111100001100000001111
10000000000011000011100000000111
10000110010000001000000000000001
100001D0010000001000001100000001
10111111110011111100011000000111
11111111111111111111111111000111
11111111111111111111110000000011
11111111111100000000000000000001
11111111111000000000000010000001
11111111111011100111000000000001
11111011111001110110001110000111
11110000011000000000001100000111
11110000010000000000000000000001
11110000000000000110000001100001
11100000000011100111000000001001
11111111111110000001111111111111
11111111111100000000111100000111
10000000000000000000111100000011
10000000000001111100011000000001
10000000000000000L00000001111101
10000000000000000L11100000111001
10000000000110000L11101000000001
10000000000111000L000010E0011001
10000000000000000100011110110001
11111001111011101110011110000101
11111111111111111111111111111111
11111111111111111111111111111111
