11111111111111111111111111111111
11111111111000000111111111111111
10000000001001100011100011100001
10001000000000000000L00000001101
11111110000000000011L00000011111
11111000011011110011L00000000001
10110000111000000011L00000000001
10000000000000000011L00001100101
10000110000000011111L00001D00101
10100000000111000000L11111111111
11100000011111111111111111111111
11000000001111000011111111111111
10000000000110000001000000000001
10001000000010000000001110011101
1000000000000L0000L0001111110001
1011100001100L1111L0001111100001
1011000001100L0000L0000100000001
1000000000000L1111L0101000000001
1000011000000L1111L0101011000001
1000000010010L1110L0000010000011
11111111111111111111111110000011
11111111111111000011111100000111
10000000000110000001011100000011
100L0000000010000000011000000001
111L110000100L0000L0000001111101
111L110000100L1111L0000000111001
111L110000000L0000L0001000000001
111L110000000L1111L01010E0011001
101L110110000L1111L0111110110001
100L000110010L1110L0011110000101
11111111111111111111111111111111
11111111111111111111111111111111
