11111111111111111111111111111111
11110111110111111111111111111111
111100010000L0100000011111111111
100000000001L1100000011111111111
100000000001L0000000011111111111
100000000000L0000000011111011111
100000000000L0000000011000001111
100001100100L0000100001000001111
100001D0010111000111100000001111
10111111110100000000100000000111
11111111111111000001111111111111
11111111111110000000011111111111
10000000000100000000000000000011
10000000000110000011100010000001
10000000000000000000011111100001
1000000000000000000L011110000111
1000000000001111111L001100001111
1000000000001000111L000000000001
1000000000011000110L000001100001
11111001111100000000101000000001
11111111111111111111111000000111
11110000011111111111101111000011
11110000001000000000000010000111
1110000000000L000000000000000001
1000011111011L11000010L000000001
1000001110011L11000010L111110001
1010000000011L11000000L000010001
1010E00110011L11000000L011011001
1111101100001L11011000L111001101
1111100001000L000110011111111101
11111111111111111111110001111111
11111111111111111111111111111111
