11111111111111111111111111111111
11111111111000000111111111111111
10000000001001100011111100000001
10001000000000000000L11000000001
11111110000000000011L11000LD1111
11111000011011110011L00000L11111
10110000111000000011L00000L11111
10000000000000000011L01100L00111
10000110000000011111L11111111111
10100000000111000000L00011100011
11100000011111111111111111111111
11100000000111000011111111111111
11000000000110000001000000000001
11100000111010000000001110011101
1000000000000L0000L0001111110001
100000000L000L1111L0001111100001
101111111L000L0000L0000100000001
101000111L000L1111L0101000000001
111000110L000L1111L0101011000001
1100000000110L1110L0000010000011
11111111111111111111111110000011
11111111111111000011111100000111
10000000001110000001011100000011
10001000000010000000011000000001
1111111000100L0000L0000001111101
1111100001100L1111L0000000111001
1011000011100L0000L0001000000001
1000001000000L1111L01010E0011001
1000001000000L1111L0111110110001
1011111100010L1110L0011110000101
11111111111111111111111111111111
11111111111111111111111111111111
