11111111111111111111111111111111
11111111111111111111111111111111
11000000000000111000000000000001
10000000000000000011000000000001
10111001110000000111100000000001
10011101100000000000000000000001
10000000000000000000000000000001
10000000000000011001000000000001
1000000110000001D001000000000001
10111001110111111111111110011111
11100000011111111111111111111111
10000000000111111111111111111111
10000000000000000000100000000011
10000000000000100000000010000001
11100000000111111000111111100001
111L0000000111100001111110000111
111L1111110011000011101100001111
100L0000010000001000000000000001
110L1111001000001000000001100001
110L0000001011111100001000000001
11111111111111111111111000000111
11110000011000000111100000000001
10011000010001100011100000000001
10001100000000000000L00000000001
10100001110000000011L11000000001
10111111110011110011L11L00000001
10011000000000000011L11L11111101
10000000000000000011L00L00000101
10001100100000011111L10L11110011
100011E1100111000000L10L00000011
11111111111111111111111111111111
11111111111111111111111111111111
