11111111111111111111111111111111
11111111111111111111111111111111
11000000000L0000000000000000L001
10000000000L1111111001011111L011
10111001110L0000000001000000L011
10011101100L0000011001001110L001
10000000000L0000011101000000L011
10000000000L0001000000000000L111
10000001100L110100000000000D0111
10111001110111111000011111110001
11100000011111111111111111111111
11000000001111111111111111111111
10000000001000000000011111111111
10011111000111011111111111111111
1000000L000101011111111111111111
1000000L111000000011111111011111
1110000L111000000001111000001111
1111000L000000000000001000001111
10000001000011000000000000001111
10111011100110000001100000000111
11111111111111110001111111111111
11111111111110000000011100000111
10000000000100000000000110000101
10000000000110000011100011000001
10000000000000000000001000011101
1000000000000000000L001111111101
1000000000001111111L000110000001
1000000000001000111L000000000001
1000000000011000110L000011001001
11111001111100000000100011E11001
11111111111111111111111111111111
11111111111111111111111111111111
