11111111111111111111111111111111
11111111111111111111111111111111
110000000L0000000000111111111111
100000001L1000100000011111111111
10001D001L0111111000011111111111
100111111L0111100001111111011111
100111111L0011000011111000001111
101111111L0000000000001000001111
111111100L0000011000000000001111
11111110000010000000000000000111
11111111111110000001111111111111
11111111111100000000111111111111
1000000000001100000010L010000001
1000000000001100L00001L110000001
1000000000001111L00001L000000001
1000000000000000L00010L000000001
1000000000000111L00010L000000001
1000000000000000L00000L000010001
1000000000000000L111011100011111
1111100111100000L100010000000011
11111111111111111111111100000111
11111111111111000011110000000011
100000000000000000L0000000000001
100L00000001011111L0100010000001
111L11000011000000L0100000000001
111L11000011001110L0001110000111
111L11000001000000L0101100000111
111L11000000000000L1100000000001
101L110110000E000001100001100001
100L0001100111111100000000001001
11111111111111111111111111111111
11111111111111111111111111111111
