11111111111111111111111111111111
11111111111111111111100000000001
100011100000L0100000000000011001
100000001101L1100000010001L01001
100000011111L0000000000000L00001
100000000000L0000000000000L11001
100000000000L0000000001110L11001
100001100100L0000100001010L11001
100001D0010111000111100000011111
11111111111100000000100000011011
11111111111111000001111111111111
11111111111000000000011111111111
11111111111000000000000000000011
11111111111000000000000010000001
11111111111110000000011111100001
1111101111111L000000011110000111
1111000001111L111111001100001111
1111000001000L000001000000000001
1111000000010L111100100001100001
1110000000010L000000101000000001
11111111111111111111111000000111
11111111111111111111100110011101
10000000000000000000000000001001
1000000000000L000000011111101111
1000000000011L110000101000000001
1000000000011L110000100000111111
1000000000011L110000000000000001
1000000000011L110000000001000001
1000000000001L110110000011000001
1111100111100L00011000011111E011
11111111111111111111111111111111
11111111111111111111111111111111
