11111111111111111111111111111111
11110111110111111111111111111111
11110001000L00000000000000000011
10000000000L11111110000010000001
10000000000L00000000011111100001
10000000000L00000110011110000111
10000000000L00000111001100001111
10000110010L00010000000000000001
100001D0010L11010000000001100001
10111111110111111000001000000001
11111111111111111111111000000111
11111111111111111111110000000011
10000000001000000000100000000001
10001000000000100000000010000001
11111110000111111000100000000001
11111000011111100001101110000111
10110000111011000011101100000111
10000000000000001000000000000001
10000110000000001000000001100001
10100000000011111100000000001001
11100000011111111111111111111111
11000000001001100111011111111111
10000000000000000010000000000011
10001000000111111011100010000001
10000000000010000000011111100011
10111000011000001111111110000111
10110000011000000000001100001111
10000000000000010000000000100001
10000110000000110000000000100001
100000001000011111E0101111110001
11111111111111111111111111111111
11111111111111111111111111111111
