11111111111111111111111111111111
11111111111000000111111111111111
10000000000011110011111100000001
10111001110000000000011000000001
10111111000000111110011000LD1111
10111110000000000000000000L11111
10010000000111000010000000L11111
10100000000111100110001100L00111
10101100000001001110011111111111
10001000001000000000000011100011
11111000001111111111111111111111
11100000000111111111111111111111
11000000000000000000100000000011
11100000111000100000000010000001
10000000000111111000111111100001
100000000L0111100001111110000111
101111111L0011000011101100001111
101000111L0000001000000000000001
111000110L0000001000000001100001
11000000001011111100001000000001
11111111111111111111111000000111
11111111111111000011111100001111
1000000000011000000100000000L001
1000000000001000000001011111L011
1000000000000L0000L001000000L011
1000000000000L1111L001001110L001
1000000000000L0000L001000000L011
1000000000000L1111L010000000L111
1000000000000L1111L0100E00000111
1111100111110L1110L0011111110001
11111111111111111111111111111111
11111111111111111111111111111111
