11111111111111111111111111111111
11111111111111111111100000000001
1000000000110000000L000000011001
1000100000000000001L110001L01001
111111100000001D001L000000L00001
1111100001100111111L000000L11001
1011000011100111111L001110L11001
1000000000001111111L001010L11001
1000011000011111100L000000011111
10100000000111111000000000011011
11100000011111111111111111111111
10111100001111111111111111111111
10001000011000000000011111111111
10000000000111011111111111111111
10L00000000101011111111111111111
10L11111000000000011111111011111
10L00001000000000001111000001111
10L01101100000000000001000001111
10L11100110011000000000000001111
11111111110110000001100000000111
11000111111111110001111111111111
10011001110100000000111111111111
10000000100000000000100000000001
11111110111001111100000000000001
10100000000000000L00000000000001
10000011111000000L11100000000001
10000000000110000L11100000000001
10000100000111000L00000000000001
10001100000000000100000000000001
10011111E01011101110011110011111
11111111111111111111111111111111
11111111111111111111111111111111
