11111111111111111111111111111111
11111111111111000000011111111111
10L01000000111001000000000000001
11L11000000100011110000000000001
11L00000000100000000000000000001
10L00000000100000101100000000001
10L0000000000000L10D100000000001
10L0000100011111L111100000000001
1111000111100011L111100000000001
1100000000100000L001111110011111
11110000011111111111111111111111
10000000000111111111111111111111
10000000000000000000010000000001
1000000000000L000000000000000001
1110000000011L110000101110011101
111L000000011L110000100111011001
111L111111011L110000000000000001
100L000001011L110000000000000001
110L111100101L110110000000011001
110L000000100L000110001110011101
11111111111111111111111000000111
11111111111111111111111100001111
1L00000000000000000010000000L001
1L11111110000010000001011111L011
1L00000000011111100011000000L011
1L00000110011110000111001110L001
1L00000111001100001111000000L011
1L00010000000000100000000000L111
1L110100000000001000000E00000111
11111110000011111100011111110001
11111111111111111111111111111111
11111111111111111111111111111111
