11111111111111111111111111111111
11111111111111111111111111111111
10000000000111000000000000000001
10111001110110000000000000000001
1011111100011000LD11100000000001
1011111000000000L111100000000001
1001000000000000L111100000000001
1010000000001100L001100000000001
10101100000111111111100000000001
10001000001000111000111110011111
11111000001111111111111111111111
11000000001000000111111111111111
10000000000011110011110000000001
10001000000000000000000000000001
10000000000000111110001110011101
10111000011000000000000111011001
10110000011111000010000000000001
10000000000111100110000000000001
10000110000001001110000000011001
10000000100000000000001110011101
11111111111111111111111000000111
11111111111000000001110000000011
1L000000000011111110101100000011
1L111111100000100000001100L00001
1L000000000000000000001111L00001
1L000001100000000000000000L00011
1L000001110011001110000111L00011
1L000100000000000000000000L00001
1L110100000000110110000000L11101
1111111000000010E110000000L10001
11111111111111111111111111111111
11111111111111111111111111111111
