11111111111111111111111111111111
11111111111111111111111111111111
11111111111111000000000000000001
11111111111110000000001110011101
1111111111111000LD11101111110001
1111101111100000L111101111100001
1111000001100000L111100100000001
1111000001001100L001101000000001
11110000000111111111101011000001
11100000000000111000100010000011
11111111111111111111111110000011
11111111111111111111111000000001
10000000000100000000010000000001
10000000000000000000011000001111
10000000000011100111000000000001
10000000000001110110000000000L01
10000000000000000000001111111L01
10000000000000000000001000111L01
10000000000000000110011000110L01
11111001111011100111010000000011
11111111111110000001111111111111
11110000111100000000111111111111
10000000L00000000000101001100L01
11011111L010011111000010L0011L11
11000000L01000000L000011L1111L11
11001110L00000000L111111L1111L11
11000000L01110000L11111100011L11
10000000L11111000L00011011000L11
100E0000011000000100011011011L11
11111111000011101110011000011111
11111111111111111111111111111111
11111111111111111111111111111111
