11111111111111111111111111111111
11111111111111111111111101111101
10000000001L00000000011100010001
10001000000L11111110000000000001
11111110000L00000000000000000001
11111000011L00000110000000000001
10110000111L00000111000000000001
10000000000L00010000000001100101
10000110000L11010000000001D00101
10100000000111111000001111111101
11100000011111111111111111111111
11100000000111111111111111111111
11000000000000000000100000000011
11100000111000100000000010000001
10000000000111111000111111100001
100000000L0111100001111110000111
101111111L0011000011101100001111
101000111L0000001000000000000001
111000110L0000001000000001100001
11000000001011111100001000000001
11111111111111111111111000000111
11111111111001100111001111000011
10000000000000000010000010000111
10000000000111111011100000000001
1000000000001000000000L000000001
1000000000000000111110L111110001
1000000000000000000000L000010001
1000000000000001000000L011011001
1000000000000011000000L111001101
111110011110011111E0111111111101
11111111111111111111110001111111
11111111111111111111111111111111
