11111111111111111111111111111111
11111111111111111111111111111111
10001110000000000000011111111111
10000000110111011111111111111111
10000001111101011111111111111111
10000000000000000011111111011111
10000000000000000001111000001111
10000110010000000000001000001111
100001D0010011000000000000001111
11111111111110000001100000000111
11111111111111110001111111111111
11111111111000000000011111111111
10000000001000000000000000000001
10001000000000000000000000000001
11111110000110000000000000000001
1111100001111L000000000000000001
1011000011111L111111000000000001
1000000000000L000001000000000001
1000011000010L111100100000000001
1010000000010L000000111110011111
11100000011111111111111111111111
11110000011111000011111111111111
10011000010110000001000000000001
10001100000010000000000L00000001
1010000111000L0000L0011L11000011
1011111111000L1111L0011L11000011
1001100000000L0000L0011L11000001
1000000000000L1111L0111L11000001
1000110010000L1111L0101L11011001
100011E110010L1110L0000L00011001
11111111111111111111111111111111
11111111111111111111111111111111
