11111111111111111111111111111111
11110000000111111111111111111111
11110010000000000000000000000011
1100011110000L000000000010000001
1100000000011L110000111111100001
1100000101111L110000111110000111
100000L10D111L110000001100001111
111111L111111L110000000000000001
100011L111101L110110000001100001
100000L001100L000110001000000001
11111111111111111111111000000111
11111111111000000111100000000001
10L01000000011110011100000000001
11L11000000000000000000000000001
11L00000000000111110011000000001
10L00000000000000000011L00000001
10L00000000111000010011L11111101
10L00001000111100110000L00000101
11110001111001001110010L11110011
11000000001000000000010L00000011
11110000011111111111111111111111
11110000111111111111111111111111
10000000L00000000000100000000001
11011111L01000100000000000000001
11000000L01111111000100000000001
11001110L00111100001100000000001
11000000L01011000011100000000001
10000000L11000001000000000000001
100E0000011000001000000000000001
11111111000011111100011110011111
11111111111111111111111111111111
11111111111111111111111111111111
