11111111111111111111111111111111
11111111111111111111100000000001
100000000000000000L0000000011001
111101111111011111L0110001L01001
110101111111000000L0100000L00001
100000001111001110L0000000L11001
100000000111000000L0101110L11001
100000000000000000L1101010L11001
10110000000000000D01100000011111
11100000011111111100000000011011
11111100011111111111111111111111
10111100001111111111111111111111
10001000011000000000011111111111
10000000000011100111011111111111
10L00000000011111100011111111111
10L11111000011111000011111011111
10L00001000001000000011000001111
10L01101100010000000001000001111
10L11100110010110000000000001111
11111111110000100000100000000111
11000111111111100000111111111111
11111111111001100111011111111111
100000000000000000100L0000000001
100000000001111110111L1111111001
100000000000100000000L0000000001
100000000000000011111L0000011001
100000000000000000000L0000011101
100000000000000100000L0001000001
100000000000001100000L1101000001
111110011110011111E0111111100001
11111111111111111111111111111111
11111111111111111111111111111111
