11111111111111111111111111111111
11111111111000000111111111111111
110000000L0011110011100000000001
100000001L1000000000011101111111
10001D001L0000111110010101111111
100111111L0000000000000000001111
100111111L0111000010000000000111
101111111L0111100110000000000001
111111100L0001001110001100000001
11111110000000000000011000000111
11111111111111111111111111000111
11111111111000000111101111000011
11000000000011110011100010000111
10000000000000000000000000000001
1011100111000011111000L000000001
1001110110000000000000L111110001
1000000000011100001000L000010001
1000000000011110011000L011011001
1000000110000100111000L111001101
10111001110000000000011111111101
11100000011111111111110001111111
10000000011111111111111111111111
101111111010000000001L0000000001
100010000000001000000L1111111001
100000000001111110001L0000000001
100000000001111000011L0000011001
101100111000110000111L0000011101
100000000000000010000L0001000001
100011011000000010000L1101000001
100010E1100011111100011111100001
11111111111111111111111111111111
11111111111111111111111111111111
