11111111111111111111111111111111
11111111111111011111011111111111
11111111111111000100010000000001
11111111111000000000000000000001
11111111111000000000001110011101
11111011111000000000000111011001
11110000011000000000000000000001
11110000010000011001000000000001
1111000000000001D001000000011001
11100000000011111111001110011101
11111111111111111111111000000111
11111111111111111111111000000001
100000000000L0100000010000000001
100000000001L1100000011000001111
100000000001L0000000000000000001
100000000000L0000000000000000L01
100000000000L0000000001111111L01
100000000000L0000100001000111L01
10000000000111000111111000110L01
11111001111100000000110000000011
11111111111111000001111111111111
10000000000100000000111111111111
10000000000000000000000000000001
10000000000000100000011000000111
10010011110000000000011101010111
10010011110011100001111111111111
10010011110011000001111010100111
10E11011110000000000000000000101
11110000000000011000000010000111
11111111110000000010000111110001
11111111111111111111111111111111
11111111111111111111111111111111
