11111111111111111111111111111111
11111111111000000111111111111111
110000000L0001100011100000000011
100000001L1000000000L00010000001
10001D001L0000000011L11111100001
100111111L0011110011L11110000111
100111111L0000000011L01100001111
101111111L0000000011L00000000001
111111100L0000011111L00001100001
11111110000111000000L01000000001
11111111111111111111111000000111
11111111111000000111101111000011
11000000000011110011100010000111
10000000000000000000000000000001
1011100111000011111000L000000001
1001110110000000000000L111110001
1000000000011100001000L000010001
1000000000011110011000L011011001
1000000110000100111000L111001101
10111001110000000000011111111101
11100000011111111111110001111111
10111100001000000000011111111111
10001000011000000000000000000001
10000000000000000000000000000001
10L00000000001001111000000000001
10L11111000001001111000000000001
10L00001000001001111000000000001
10L011011000E1101111000000000001
10L11100110111000000000000000001
11111111110111111111011110011111
11000111111111111111111111111111
11111111111111111111111111111111
