11111111111111111111111111111111
11111111111111011111011111111111
1000000000011100010000L010000001
1000000000000000000001L110000001
1000000000000000000001L000000001
1000000000000000000000L000000001
1000000000000000000000L000000001
1000000000000001100100L000010001
1000000000000001D001011100011111
11111001111011111111010000000011
11111111111111111111111100000111
11111111111111111111110000000011
10000000000L00000000000000000001
11110111111L11111110000010000001
11010111111L00000000000000000001
10000000111L00000110001110000111
10000000011L00000111001100000111
10000000000L00010000000000000001
10110000000L11010000000001100001
11100000011111111000000000001001
11111100011111111111111111111111
10000000000111111111111111111111
10000000000000000000111111111111
10000000000000100000011111111111
10010011110111111000111111111111
10010011110111100001111111011111
10010011110011000011111000001111
10E11011110000001000001000001111
11110000000000001000000000001111
11111111110011111100000000000111
11111111111111111111111111111111
11111111111111111111111111111111
