11111111111111111111111111111111
11111111111111111111111111111111
11110000000000000000101001100L01
111000000000001000000010L0011L11
111000LD1111111110000011L1111L11
100000L11111111000011111L1111L11
100000L1111011000011111100011L11
101100L0011000000000011011000L11
11111111111000011000011011011L11
10001110001010000000011000011111
11111111111110000001111111111111
11111111111100000000111111111111
1111111111100000000010L010000001
1111111111100111110001L110000001
11111111111000000L0001L000000001
11111011111000000L1110L000000001
11110000011110000L1110L000000001
11110000010111000L0000L000010001
11110000000000000100011100011111
11100000000011101110010000000011
11111111111111111111111100000111
11111111111111000011110000000011
100000000000000000L0001100000011
100000000001011111L0101100L00001
100000000001000000L0101111L00001
100000000001001110L0000000L00011
100000000001000000L0100111L00011
100000000000000000L1100000L00001
1000000000000E000001100000L11101
11111001111111111100000000L10001
11111111111111111111111111111111
11111111111111111111111111111111
