11111111111111111111111111111111
11111111111111111111111111111111
100000000000000000L0000000000001
100000000001011111L0111101111111
100000000001000000L0110101111111
100000000001001110L0000000001111
100000000001000000L0100000000111
100000000000000000L1100000000001
10000000000000000D01101100000001
11111001111111111100011000000111
11111111111111111111111111000111
11111111111111000011100000000001
10000000001110000001000000000001
10001000000010000000000000000001
1111111000000L0000L0011000000001
1111100001100L1111L0011L00000001
1011000011100L0000L0011L11111101
1000000000000L1111L0100L00000101
1000011000000L1111L0110L11110011
1010000000010L1110L0010L00000011
11100000011111111111111111111111
11000000001111000011111100001111
100000000010000000L0011000000101
100111110001011111L0101000000001
1000000L0001000000L0100L0000L001
1000000L1111001110L0000L1111L001
1110000L1111000000L0100L0000L001
1111000L0000000000L1100L1111L011
1000000100000E000001100L1111L011
10111011100111111100010L1110L001
11111111111111111111111111111111
11111111111111111111111111111111
