11111111111111111111111111111111
11111111111111111111111111111111
10000000000000000000100011100001
10000000000000100000000000001101
10000000000111111000000000011111
10000000000111100001100000000001
10000000000011000011100000000001
10000000000000000000000001100101
10000000000000011000000001D00101
11111001111010000000011111111111
11111111111110000001111111111111
11111111111110000000011111111111
11000000000100000000011111111111
10000000000110000011111111111111
10111001110000000000011111111111
1001110110000000000L011111011111
1000000000001111111L011000001111
1000000000001000111L001000001111
1000000110011000110L000000001111
10111001110100000000100000000111
11100000011111111111111111111111
11000000001111111111111100000111
10000000001L00000000011100000011
10011111000L11111110011000000001
1000000L000L00000000000001111101
1000000L111L00000110000000111001
1110000L111L00000111001000000001
1111000L000L000100000010E0011001
10000001000L11010000011110110001
10111011100111111000011110000101
11111111111111111111111111111111
11111111111111111111111111111111
