11111111111111111111111111111111
11111111111111000000011111111111
10000000000111001000000000000011
10000000000100011110000010000001
10000000000100000000011111100001
10000000000100000101111110000111
1000000000000000L10D101100001111
1000000000011111L111100000000001
1000000000000011L111100001100001
1111100111100000L001101000000001
11111111111111111111111000000111
11111111111111000011110000000011
10000000000110000001001100000011
10111001110010000000001100L00001
1011111100000L0000L0001111L00001
1011111000000L1111L0000000L00011
1001000000000L0000L0000111L00011
1010000000000L1111L0100000L00001
1010110000000L1111L0100000L11101
1000100000110L1110L0000000L10001
11111000001111111111111111111111
11100000000111000011111111111111
110000000000000000L0011111111111
111000001111011111L0111111111111
100000000001000000L0111111111111
100000000L01001110L0011111011111
101111111L01000000L0111000001111
101000111L00000000L1101000001111
111000110L000E000001100000001111
11000000001111111100000000000111
11111111111111111111111111111111
11111111111111111111111111111111
