11111111111111111111111111111111
11111111111111000011111111111111
10000000000110000001011100000001
11110111111010000000011000000001
1101011111100L0000L0011000LD1111
1000000011100L1111L0000000L11111
1000000001100L0000L0000000L11111
1000000000000L1111L0101100L00111
1011000000000L1111L0111111111111
1110000001110L1110L0000011100011
11111100011111111111111111111111
11000000001111000011111111111111
10000000001110000001000000000011
10011111000010000000000010000001
1000000L00000L0000L0011111100001
1000000L11100L1111L0011110000111
1110000L11100L0000L0001100001111
1111000L00000L1111L0100000000001
1000000100000L1111L0100001100001
1011101110010L1110L0001000000001
11111111111111111111111000000111
10000001111111000001110000000011
10011000111001100001001100000011
1000000000L000110000001100L00001
1000000011L010000111001111L00001
1011110011L011111111000000L00011
1000000011L001100000000111L00011
1000000011L000000000000000L00001
1000011111L000110010000000L11101
1111000000L00011E110000000L10001
11111111111111111111111111111111
11111111111111111111111111111111
