11111111111111111111111111111111
11111111111111111111111101111101
10000000000000000000111100010001
10111001110000100000000000000001
10111111000111111000100000000001
10111110000111100001100000000001
10010000000011000011100000000001
10100000000000001000000001100101
10101100000000001000000001D00101
10001000001011111100001111111101
11111000001111111111111111111111
11000000001000000111111111111111
10000000000011110011100000000001
10001000000000000000011101111111
10000000000000111110010101111111
10111000011000000000000000001111
10110000011111000010000000000111
10000000000111100110000000000001
10000110000001001110001100000001
10000000100000000000011000000111
11111111111111111111111111000111
11111111111111000011111000000001
100000000000000000L0010000000001
100000000001011111L0111000001111
100000000001000000L0100000000001
100000000001001110L0000000000L01
100000000001000000L0101111111L01
100000000000000000L1101000111L01
1000000000000E000001111000110L01
11111001111111111100010000000011
11111111111111111111111111111111
11111111111111111111111111111111
