11111111111111111111111111111111
11111111111111000011111101111101
10000000001110000001011100010001
10001000000010000000000000000001
1111111000000L0000L0000000000001
1111100001100L1111L0000000000001
1011000011100L0000L0000000000001
1000000000000L1111L0100001100101
1000011000000L1111L0100001D00101
1010000000010L1110L0001111111101
11100000011111111111111111111111
11000000001111111111111111111111
10110000001L0000000000L010000001
101100L0000L1111111001L110000001
101111L0000L0000000001L000000001
100000L0001L0000011000L000000001
100111L0001L0000011100L000000001
100000L0000L0001000000L000010001
100000L1110L11010000011100011111
100000L1000111111000010000000011
11111111111111111111111100000111
11111111111000000111111100000111
10000000000011110011111100000011
100L0000000000000000011000000001
111L1100001000111110000001111101
111L1100001000000000000000111001
111L1100000111000010001000000001
111L11000001111001100010E0011001
101L1101100001001110011110110001
100L0001100000000000011110000101
11111111111111111111111111111111
11111111111111111111111111111111
