11111111111111111111111111111111
11111111111000000111111111111111
110000000L0001100011100000000011
100000001L1000000000L00010000001
10001D001L0000000011L11111100001
100111111L0011110011L11110000111
100111111L0000000011L01100001111
101111111L0000000011L00000000001
111111100L0000011111L00001100001
11111110000111000000L01000000001
11111111111111111111111000000111
11111111111000000111111000000001
10000000000011110011110000000001
11110111111000000000011000001111
11010111111000111110000000000001
10000000111000000000000000000L01
10000000011111000010001111111L01
10000000000111100110001000111L01
10110000000001001110011000110L01
11100000011000000000010000000011
11111100011111111111111111111111
10011001110111000011111111111111
10000000100110000001000000000001
11111110111010000000000000000001
1010000000000L0000L0000000000001
1000001111100L1111L0000000000001
1000000000000L0000L0000000000001
1000010000000L1111L0100000000001
1000110000000L1111L0100000000001
10011111E0110L1110L0011110011111
11111111111111111111111111111111
11111111111111111111111111111111
