11111111111111111111111111111111
11111111111111111111111111111111
10L01000000000000000010000000L01
11L1100000000L000000000000001L11
11L0000000011L11000010001D001L01
10L0000000011L110000100111111L01
10L0000000011L110000000111111L01
10L0000100011L110000001111111L01
1111000111101L110110011111100L01
1100000000100L000110011111100001
11110000011111111111111111111111
10111100001111111111111111111111
10001000011000000000010000000001
1000000000000L000000000000000001
10L0000000011L110000101110011101
10L1111100011L110000100111011001
10L0000100011L110000000000000001
10L0110110011L110000000000000001
10L1110011001L110110000000011001
1111111111000L000110001110011101
11000111111111111111111000000111
11110000011111111111110000000011
11110000001000000000100000000011
11100000000000100000000111110001
100001111101111110001000000L0001
100000111001111000011000000L1111
101000000000110000111110000L1111
1010E0011000000010000111000L0001
11111011000000001000000000010001
11111000010011111100001110111001
11111111111111111111111111111111
11111111111111111111111111111111
