11111111111111111111111111111111
11111111111000000111111111111111
10000000000011110011111100000001
10111001110000000000011000000001
10111111000000111110011000LD1111
10111110000000000000000000L11111
10010000000111000010000000L11111
10100000000111100110001100L00111
10101100000001001110011111111111
10001000001000000000000011100011
11111000001111111111111111111111
11100000000111111111111111111111
11000000000000000000000000000011
1110000011100L000000000010000001
1000000000011L110000111111100001
100000000L011L110000111110000111
101111111L011L110000001100001111
101000111L011L110000000000000001
111000110L001L110110000001100001
1100000000100L000110001000000001
11111111111111111111111000000111
11111111111111000001111000000001
10000000000111000000110000000001
10000000000110000000011000001111
10000000000000011111000000000001
10000000000000001110000000000L01
10000000000010000000001111111L01
10000000000010E00110001000111L01
10000000000111101100011000110L01
11111001111111100001010000000011
11111111111111111111111111111111
11111111111111111111111111111111
