11111111111111111111111111111111
11111111111111111111111111111111
11110000000000000000000000000001
1110000000000L000000011101111111
111000LD11111L110000110101111111
100000L111111L110000100000001111
100000L111111L110000000000000111
101100L001111L110000000000000001
1111111111101L110110001100000001
1000111000100L000110011000000111
11111111111111111111111111000111
11111111111111111111101111000011
10000000000000000000100010000111
10000000000000100000000000000001
1000000000011111100000L000000001
1000000000011110000110L111110001
1000000000001100001110L000010001
1000000000000000000000L011011001
1000000000000001100000L111001101
11111001111010000000011111111101
11111111111110000001110001111111
11110000011110000000011111111111
11110000001100000000011111111111
11100000000110000011111111111111
10000111110000000000011111111111
1000001110000000000L011111011111
1010000000001111111L011000001111
1010E00110001000111L001000001111
1111101100011000110L000000001111
11111000010100000000100000000111
11111111111111111111111111111111
11111111111111111111111111111111
