11111111111111111111111111111111
11111111111111000011111111111111
10000000000110000001000011100001
10111001110010000000000000001101
1011111100000L0000L0000000011111
1011111000000L1111L0000000000001
1001000000000L0000L0000000000001
1010000000000L1111L0100001100101
1010110000000L1111L0100001D00101
1000100000110L1110L0011111111111
11111000001111111111111111111111
11000000001000000111111111111111
10000000001001100011100000000001
10011111000000000000L11101111111
1000000L000000000011L10101111111
1000000L111011110011L00000001111
1110000L111000000011L00000000111
1111000L000000000011L00000000001
10000001000000011111L01100000001
10111011100111000000L11000000111
11111111111111111111111111000111
10011001110111111111101111000011
10000000100L00000000000010000111
11111110111L11111110000000000001
10100000000L0000000000L000000001
10000011111L0000011000L111110001
10000000000L0000011100L000010001
10000100000L0001000000L011011001
10001100000L1101000000L111001101
10011111E01111111000011111111101
11111111111111111111110001111111
11111111111111111111111111111111
