11111111111111111111111111111111
11110000000111111111111111111111
11110010000100000000011111111111
11000111100000000000011111111111
11000000000011100111011111111111
11000001011001110110011111011111
100000L10D1000000000011000001111
111111L1111000000000001000001111
100011L1111000000110000000001111
100000L0011011100111000000000111
11111111111110000001111111111111
11111111111110000000011111111111
10000000000100000000000000000001
10000000000110000011111101111111
10000000000000000000010101111111
1000000000000000000L000000001111
1000000000001111111L000000000111
1000000000001000111L000000000001
1000000000011000110L001100000001
11111001111100000000111000000111
11111111111111111111111111000111
10000000011000000111101111000011
10111111101011110011100010000111
10001000000000000000000000000001
1000000000000011111000L000000001
1000000000000000000000L111110001
1011001110011100001000L000010001
1000000000011110011000L011011001
1000110110000100111000L111001101
100010E1100000000000011111111101
11111111111111111111110001111111
11111111111111111111111111111111
