11111111111111111111111111111111
11111111111000000111111100000001
10000000000011110011111100100001
10111001110000000000010001111001
10111111000000111110010000000001
10111110000000000000010000010111
10010000000111000010000000L10D11
10100000000111100110011111L11111
10101100000001001110000011L11111
10001000001000000000000000L00111
11111000001111111111111111111111
11000000001111111111111111111111
10000000001000000000011111111111
10011111000111011111111111111111
1000000L000101011111111111111111
1000000L111000000011111111011111
1110000L111000000001111000001111
1111000L000000000000001000001111
10000001000011000000000000001111
10111011100110000001100000000111
11111111111111110001111111111111
11111111111100000000111100000111
10000000000011000000111100000011
1000000000001100L000011000000001
1000000000001111L000000001111101
1000000000000000L000100000111001
1000000000000111L000101000000001
1000000000000000L0000010E0011001
1000000000000000L111011110110001
1111100111100000L100011110000101
11111111111111111111111111111111
11111111111111111111111111111111
