11111111111111111111111111111111
11111111111111111111111111111111
10L01000000000000000100011100001
11L11000000000100000000000001101
11L00000000111111000100000011111
10L00000000111100001100000000001
10L00000000011000011100000000001
10L00001000000001000000001100101
11110001111000001000000001D00101
11000000001011111100011111111111
11110000011111111111111111111111
11000000001000000111111111111111
10000000000001100011100000000011
10001000000000000000L00010000001
10000000000000000011L11111100001
10111000011011110011L11110000111
10110000011000000011L01100001111
10000000000000000011L00000000001
10000110000000011111L00001100001
10000000100111000000L01000000001
11111111111111111111111000000111
10000000000000000111110000000011
10000000000011110011100000000001
10000000000000000000000010000001
10010011110000111110000000000001
10010011110000000000001110000111
10010011110111000010001100000111
10E11011110111100110000000000001
11110000000001001110000001100001
11111111110000000000000000001001
11111111111111111111111111111111
11111111111111111111111111111111
