11111111111111111111111111111111
11111111111111000011111111111111
10L01000000110000001011100000001
11L11000000010000000011000000001
11L0000000000L0000L0011000LD1111
10L0000000000L1111L0000000L11111
10L0000000000L0000L0000000L11111
10L0000100000L1111L0101100L00111
1111000111100L1111L0111111111111
1100000000110L1110L0000011100011
11110000011111111111111111111111
11000000001111111111111111111111
10110000001000000000000000000011
101100L000000L000000000010000001
101111L000011L110000111111100001
100000L000111L110000111110000111
100111L000111L110000001100001111
100000L000011L110000000000000001
100000L111001L110110000001100001
100000L100000L000110001000000001
11111111111111111111111000000111
10000001111000000111111100000111
10111100111001100011100110000101
10000000000000000000L00011000001
10001111100000000011L01000011101
10000000000011110011L01111111101
11110000100000000011L00110000001
11111001100000000011L00000000001
10010011100000011111L00011001001
10000000000111000000L00011E11001
11111111111111111111111111111111
11111111111111111111111111111111
