11111111111111111111111111111111
11111111111111111111111111111111
11000000000111000000011111111111
10000000000110000000011111111111
1011100111011000LD11111111111111
1001110110000000L111111111011111
1000000000000000L111111000001111
1000000000001100L001101000001111
10000001100111111111100000001111
10111001110000111000100000000111
11100000011111111111111111111111
11000000001111111111111111111111
10000000001000000000110000000001
10011111000000100000000000000001
1000000L000111111000101110011101
1000000L111111100001100111011001
1110000L111011000011100000000001
1111000L000000001000000000000001
10000001000000001000000000011001
10111011100011111100001110011101
11111111111111111111111000000111
11111111111000000001110000000011
10000000000011111110100000000011
10000000000000100000000111110001
100000000000000000000000000L0001
100000000000000000000000000L1111
100000000000110011100110000L1111
100000000000000000000111000L0001
10000000000000110110000000010001
1111100111100010E110001110111001
11111111111111111111111111111111
11111111111111111111111111111111
