11111111111111111111111111111111
11110000000000000111111111111111
11110010000011110011100000000011
11000111100000000000000010000001
11000000000000111110011111100001
11000001011000000000011110000111
100000L10D1111000010001100001111
111111L1111111100110000000000001
100011L1111001001110000001100001
100000L0011000000000001000000001
11111111111111111111111000000111
11111111111111000011111000000001
10000000001110000001010000000001
10001000000010000000011000001111
1111111000000L0000L0000000000001
1111100001100L1111L0000000000L01
1011000011100L0000L0001111111L01
1000000000000L1111L0101000111L01
1000011000000L1111L0111000110L01
1010000000010L1110L0010000000011
11100000011111111111111111111111
11000000001001100111000000011111
10000000001000000010000110001111
100111110001111110111000000000L1
1000000L0000100000000000000011L1
1000000L1110000011111011110011L1
1110000L1110000000000000000011L1
1111000L0000000100000000000011L1
100000010000001100000000011111L1
101110111000011111E01111000000L1
11111111111111111111111111111111
11111111111111111111111111111111
