11111111111111111111111111111111
11111111111000000111111111111111
10000000001011110011110000000L01
10001000000000000000000000001L11
1111111000000011111000001D001L01
11111000011000000000000111111L01
10110000111111000010000111111L01
10000000000111100110001111111L01
10000110000001001110011111100L01
10100000000000000000011111100001
11100000011111111111111111111111
10111100001000000111111111111111
10001000011011110011100000000001
10000000000000000000011101111111
10L00000000000111110010101111111
10L11111000000000000000000001111
10L00001000111000010000000000111
10L01101100111100110000000000001
10L11100110001001110001100000001
11111111110000000000011000000111
11000111111111111111111111000111
11111111111111000001110000000011
10000000001001100001000000000001
10001000000000110000000010000001
11111110001010000111000000000001
11111000011011111111001110000111
10110000111001100000001100000111
10000010000000000000000000000001
10000010000000110010000001100001
1011111100000011E110000000001001
11111111111111111111111111111111
11111111111111111111111111111111
