11111111111111111111111111111111
11111111111000000111111111111111
10000000000001100011111100000001
11110111111000000000L11000000001
11010111111000000011L11000LD1111
10000000111011110011L00000L11111
10000000011000000011L00000L11111
10000000000000000011L01100L00111
10110000000000011111L11111111111
11100000011111000000L00011100011
11111100011111111111111111111111
11100000000111000011111111111111
11000000000110000001000000000011
11100000111010000000000010000001
1000000000000L0000L0011111100001
100000000L000L1111L0011110000111
101111111L000L0000L0001100001111
101000111L000L1111L0100000000001
111000110L000L1111L0100001100001
1100000000110L1110L0001000000001
11111111111111111111111000000111
11110000111001100111010000000011
11100000010000000010000000000001
10100000000111111011100010000001
100L0000L00010000000000000000001
100L1111L00000001111101110000111
100L0000L00000000000001100000111
100L1111L01000010000000000000001
100L1111L01000110000000001100001
110L1110L000011111E0100000001001
11111111111111111111111111111111
11111111111111111111111111111111
