11111111111111111111111111111111
11111111111111111111111111111111
100000000010000000L0011111111111
100010000001011111L0111111111111
111111100001000000L0111111111111
111110000111001110L0011111011111
101100001111000000L0111000001111
100000000000000000L1101000001111
10000110000000000D01100000001111
10100000000111111100000000000111
11100000011111111111111111111111
10000000000000000111111111111111
10000000000011110011100000000001
10000000000000000000011101111111
11100000000000111110010101111111
111L0000000000000000000000001111
111L1111110111000010000000000111
100L0000010111100110000000000001
110L1111001001001110001100000001
110L0000001000000000011000000111
11111111111111111111111111000111
11111111111000000111100000000111
10000000000001100011101111111011
10000000000000000000L00010000001
10000000000000000011L00000000001
10000000000011110011L00000000001
10000000000000000011L01100111001
10000000000000000011L00000000001
10000000000000011111L00011011001
11111001111111000000L00010E11001
11111111111111111111111111111111
11111111111111111111111111111111
