11111111111111111111111111111111
11111111111111111111111111111111
100000000000000000L000L010000001
100000000001011111L011L110000001
100000000001000000L011L000000001
100000000001001110L000L000000001
100000000001000000L010L000000001
100000000000000000L110L000010001
10000000000000000D01111100011111
11111001111111111100010000000011
11111111111111111111111100000111
11111111111111111111111000000001
10000000001000000000110000000001
10001000000000100000011000001111
11111110000111111000100000000001
11111000011111100001100000000L01
10110000111011000011101111111L01
10000000000000001000001000111L01
10000110000000001000011000110L01
10100000000011111100010000000011
11100000011111111111111111111111
11110000111111111111111111111111
10000000L00000000000000000000011
11011111L0100L000000000010000001
11000000L0111L110000111111100011
11001110L0011L110000111110000111
11000000L0111L110000001100001111
10000000L1111L110000000000100001
100E000001101L110110000000100001
1111111100000L000110001111110001
11111111111111111111111111111111
11111111111111111111111111111111
