11111111111111111111111111111111
11111111111111111111111111111111
1111111111110000000L000000000001
1111111111100000001L111101111111
111111111110001D001L010101111111
1111101111100111111L000000001111
1111000001100111111L000000000111
1111000001001111111L000000000001
1111000000011111100L001100000001
11100000000111111000011000000111
11111111111111111111111111000111
11111111111111111111111000000001
10000000000000000000010000000001
10000000000011100111011000001111
10000000000011111100000000000001
10000000000011111000000000000L01
10000000000001000000001111111L01
10000000000010000000001000111L01
10000000000010110000011000110L01
11111001111000100000110000000011
11111111111111100000111111111111
11111111111000000000011111111111
10000000001000000000000000000001
10001000000000000000011000000111
11111110001001001111011101010111
11111000011001001111011111111111
10110000111001001111011010100111
100000100000E1101111000000000101
10000010000111000000000010000111
10111111000111111111000111110001
11111111111111111111111111111111
11111111111111111111111111111111
