11111111111111111111111111111111
11110000000111111111111111111111
1111001000000000000010L010000001
1100011110000010000001L110000001
1100000000011111100011L000000001
1100000101111110000110L000000001
100000L10D101100001110L000000001
111111L111100000100000L000010001
100011L1111000001000011100011111
100000L0011011111100010000000011
11111111111111111111111100000111
11111111111000000111101111000011
10000000001001100011100010000111
10001000000000000000L00000000001
11111110000000000011L0L000000001
11111000011011110011L0L111110001
10110000111000000011L0L000010001
10000000000000000011L0L011011001
10000110000000011111L0L111001101
10100000000111000000L11111111101
11100000011111111111110001111111
11000000001111000001111111111111
10110000001001100001000000000001
101100L0000000110000000000000001
101111L0000010000111000000000001
100000L0001011111111000000000001
100111L0001001100000000000000001
100000L0000000000000000000000001
100000L1110000110010000000000001
100000L100000011E110011110011111
11111111111111111111111111111111
11111111111111111111111111111111
