11111111111111111111111111111111
11111111111111000000011111111111
10000000000111001000010000011011
10111001110100011110010000011011
10111111000100000000011100011011
10111110000100000101110000011111
1001000000000000L10D110000001111
1010000000011111L111100000000001
1010110000000011L111100000000001
1000100000100000L001100011110011
11111000001111111111111111111111
11100000000111111111111111111111
110000000000L0100000011111111111
111000001111L1100000011111111111
100000000001L0000000011111111111
100000000L00L0000000011111011111
101111111L00L0000000011000001111
101000111L00L0000100001000001111
111000110L0111000111100000001111
11000000001100000000100000000111
11111111111111000001111111111111
10000001111000000001111111111111
10111100111011111110100000000001
10000000000000100000000000000001
10001111100000000000000000000001
10000000000000000000000000000001
11110000100011001110000000000001
11111001100000000000000000000001
10010011100000110110000000000001
1000000000000010E110011110011111
11111111111111111111111111111111
11111111111111111111111111111111
