11111111111111111111111111111111
11110111110000000111111111111111
11110001000011110011100000000001
10000000000000000000011101111111
10000000000000111110010101111111
10000000000000000000000000001111
10000000000111000010000000000111
10000110010111100110000000000001
100001D0010001001110001100000001
10111111110000000000011000000111
11111111111111111111111111000111
11111111111111111111110000000011
10000000000000000000100000000001
10000000000000100000000010000001
10000000000111111000000000000001
10000000000111100001101110000111
10000000000011000011101100000111
10000000000000000000000000000001
10000000000000011000000001100001
11111001111010000000000000001001
11111111111110000001111111111111
11110000011011110000111111111111
11110000001000100001111111111111
11100000000000000000011111111111
100001111100L0000000011111111111
100000111000L1111100011111011111
101000000000L0000100011000001111
1010E0011000L0110110001000001111
111110110000L1110011000000001111
11111000010111111111000000000111
11111111111100011111111111111111
11111111111111111111111111111111
