11111111111111111111111111111111
11110111110000000111111111111111
11110001000011110011100000000001
10000000000000000000011101111111
10000000000000111110010101111111
10000000000000000000000000001111
10000000000111000010000000000111
10000110010111100110000000000001
100001D0010001001110001100000001
10111111110000000000011000000111
11111111111111111111111111000111
11111111111000000111100000000001
10000000000011110011100000000001
10111001110000000000000000000001
10111111000000111110011000000001
10111110000000000000011L00000001
10010000000111000010011L11111101
10100000000111100110000L00000101
10101100000001001110010L11110011
10001000001000000000010L00000011
11111000001111111111111111111111
11000000001001100111011111111111
10110000001000000010000000000001
101100L0000111111011100000000001
101111L0000010000000000000000001
100000L0001000001111100000000001
100111L0001000000000000000000001
100000L0000000010000000000000001
100000L1110000110000000000000001
100000L10000011111E0111110011111
11111111111111111111111111111111
11111111111111111111111111111111
