11111111111111111111111111111111
11111111111111111111100000000001
10L0100000010000000L000000011001
11L1100000000000001L110001L01001
11L000000000001D001L000000L00001
10L0000000000111111L000000L11001
10L0000000000111111L001110L11001
10L0000100001111111L001010L11001
1111000111111111100L000000011111
11000000001111111000000000011011
11110000011111111111111111111111
10111100001111111111111111111111
10001000011000000000111111111111
10000000000000100000011111111111
10L00000000111111000011111111111
10L11111000111100001111111011111
10L00001000011000011111000001111
10L01101100000000000001000001111
10L11100110000011000000000001111
11111111110010000000000000000111
11000111111110000001111111111111
11111111111001100111011111111111
10000000000000000010000000000011
10000000000111111011100010000001
10000000000010000000011111100011
10000000000000001111111110000111
10000000000000000000001100001111
10000000000000010000000000100001
10000000000000110000000000100001
111110011110011111E0101111110001
11111111111111111111111111111111
11111111111111111111111111111111
