11111111111111111111111111111111
11111111111111111111111100000001
10000000001000000000111100100001
10001000000000100000010001111001
11111110000111111000110000000001
11111000011111100001110000010111
10110000111011000011100000L10D11
10000000000000001000011111L11111
10000110000000001000000011L11111
10100000000011111100000000L00111
11100000011111111111111111111111
11000000001000000111111111111111
10000000000011110011100000000011
10001000000000000000000010000001
10000000000000111110011111100001
10111000011000000000011110000111
10110000011111000010001100001111
10000000000111100110000000000001
10000110000001001110000001100001
10000000100000000000001000000001
11111111111111111111111000000111
11110000111001100111010000000011
11100000010000000010000000000001
10100000000111111011100010000001
100L0000L00010000000000000000001
100L1111L00000001111101110000111
100L0000L00000000000001100000111
100L1111L01000010000000000000001
100L1111L01000110000000001100001
110L1110L000011111E0100000001001
11111111111111111111111111111111
11111111111111111111111111111111
