11111111111111111111111111111111
11111111111111011111011111111111
1111111111111100010000L010000001
1111111111100000000001L110000001
1111111111100000000001L000000001
1111101111100000000000L000000001
1111000001100000000000L000000001
1111000001000001100100L000010001
1111000000000001D001011100011111
11100000000011111111010000000011
11111111111111111111111100000111
11111111111111111111110000000011
10000000000100000000000000000011
10000000000000000000000111110001
100000000000111001110000000L0001
100000000000011101100000000L1111
100000000000000000000110000L1111
100000000000000000000111000L0001
10000000000000000110000000010001
11111001111011100111001110111001
11111111111110000001111111111111
10000000011011110000111111111111
10111111101000100001100000000001
10001000000000000000011000000111
100000000000L0000000011101010111
100000000000L1111100011111111111
101100111000L0000100011010100111
100000000000L0110110000000000101
100011011000L1110011000010000111
100010E1100111111111000111110001
11111111111100011111111111111111
11111111111111111111111111111111
