11111111111111111111111111111111
11111111111111111111111111111111
10L01000000111000000000000000001
11L11000000110000000000000000001
11L0000000011000LD11100000000001
10L0000000000000L111100000000001
10L0000000000000L111100000000001
10L0000100001100L001100000000001
11110001111111111111100000000001
11000000001000111000111110011111
11110000011111111111111111111111
10111100001111000011111111111111
10001000011110000001000000000011
10000000000010000000000010000001
10L0000000000L0000L0011111100001
10L1111100000L1111L0011110000111
10L0000100000L0000L0001100001111
10L0110110000L1111L0100000000001
10L1110011000L1111L0100001100001
1111111111010L1110L0001000000001
11000111111111111111111000000111
11111111111001100111000000000001
10000000000000000010000000000001
100L0000000111111011100000000001
111L1100001010000000011000000001
111L1100001000001111111L00000001
111L1100000000000000011L11111101
111L1100000000010000000L00000101
101L1101100000110000010L11110011
100L00011000011111E0110L00000011
11111111111111111111111111111111
11111111111111111111111111111111
