11111111111111111111111111111111
11111111111111111111111111111111
11111111111000000000111100000001
11111111111000100000011000000001
11111111111111111000011000LD1111
11111011111111100001100000L11111
11110000011011000011100000L11111
11110000010000000000001100L00111
11110000000000011000011111111111
11100000000010000000000011100011
11111111111110000001111111111111
11111111111100000000111111111111
10000000000011000000100000000001
1000000000001100L000001110011101
1000000000001111L000001111110001
1000000000000000L000101111100001
1000000000000111L000100100000001
1000000000000000L000001000000001
1000000000000000L111001011000001
1111100111100000L100000010000011
11111111111111111111111110000011
10000001111111000011100000000001
10011000111110000001000000000001
1000000000L010000000000000000001
1000000011L00L0000L0000100111101
1011110011L00L1111L0000100111101
1000000011L00L0000L0000100111101
1000000011L00L1111L010E110111101
1000011111L00L1111L0111100000001
1111000000L10L1110L0011111111101
11111111111111111111111111111111
11111111111111111111111111111111
