11111111111111111111111111111111
11111111111111111111111111111111
11110000000000000000011111111111
11100000000111011111111111111111
111000LD111101011111111111111111
100000L1111000000011111111011111
100000L1111000000001111000001111
101100L0011000000000001000001111
11111111111011000000000000001111
10001110001110000001100000000111
11111111111111110001111111111111
11111111111011110000111111111111
10000000000000100001100000000001
10111001110000000000000000000001
101111110000L0000000000000000001
101111100000L1111100000000000001
100100000000L0000100000000000001
101000000000L0110110000000000001
101011000000L1110011000000000001
10001000001111111111011110011111
11111000001100011111111111111111
11110000011111000011111111111111
100110000101100000010L0000000001
100011000000100000000L1111111001
1010000111000L0000L00L0000000001
1011111111000L1111L00L0000011001
1001100000000L0000L00L0000011101
1000000000000L1111L01L0001000001
1000110010000L1111L01L1101000001
100011E110010L1110L0011111100001
11111111111111111111111111111111
11111111111111111111111111111111
