11111111111111111111111111111111
11111111111111000000011111111111
10000000000111001000000000000001
11110111111100011110000000000001
11010111111100000000000000000001
10000000111100000101100000000001
1000000001100000L10D100000000001
1000000000011111L111100000000001
1011000000000011L111100000000001
1110000001100000L001111110011111
11111100011111111111111111111111
11000000001111111111111111111111
10000000000000000000100000000001
10001000000000100000001110011101
10000000000111111000101111110001
10111000011111100001101111100001
10110000011011000011100100000001
10000000000000001000001000000001
10000110000000001000001011000001
10000000100011111100000010000011
11111111111111111111111110000011
11110000111000000111111000000001
10000000L00001100011110000000001
11011111L01000000000L11000001111
11000000L01000000011L00000000001
11001110L00011110011L00000000L01
11000000L01000000011L01111111L01
10000000L11000000011L01000111L01
100E0000011000011111L11000110L01
11111111000111000000L10000000011
11111111111111111111111111111111
11111111111111111111111111111111
