11111111111111111111111111111111
11111111111111000000011111111111
10000000000111001000010000011011
10111001110100011110010000011011
10111111000100000000011100011011
10111110000100000101110000011111
1001000000000000L10D110000001111
1010000000011111L111100000000001
1010110000000011L111100000000001
1000100000100000L001100011110011
11111000001111111111111111111111
11100000000111111111111111111111
11000000000000000000011111111111
11100000111011100111011111111111
10000000000011111100011111111111
100000000L0011111000011111011111
101111111L0001000000011000001111
101000111L0010000000001000001111
111000110L0010110000000000001111
11000000001000100000100000000111
11111111111111100000111111111111
11111111111000000000011111111111
10000000000000000000000000000001
100L0000000000000000000000000001
111L1100001001001111000000000001
111L1100001001001111000000000001
111L1100000001001111000000000001
111L11000000E1101111000000000001
101L1101100111000000000000000001
100L0001100111111111011110011111
11111111111111111111111111111111
11111111111111111111111111111111
