11111111111111111111111111111111
11111111111111111111111111111111
1000000000011100000000L010000001
1000000000011000000001L110000001
1000000000011000LD1111L000000001
1000000000000000L11110L000000001
1000000000000000L11110L000000001
1000000000001100L00110L000010001
10000000000111111111111100011111
11111001111000111000110000000011
11111111111111111111111100000111
11111111111111111111101111000011
10000000000L00000000000010000111
11110111111L11111110000000000001
11010111111L0000000000L000000001
10000000111L0000011000L111110001
10000000011L0000011100L000010001
10000000000L0001000000L011011001
10110000000L1101000000L111001101
11100000011111111000011111111101
11111100011111111111110001111111
11110000011111000011111100001111
11110000001110000001011000000101
11100000000010000000001000000001
1000011111000L0000L0000L0000L001
1000001110000L1111L0000L1111L001
1010000000000L0000L0000L0000L001
1010E00110000L1111L0100L1111L011
1111101100000L1111L0100L1111L011
1111100001010L1110L0010L1110L001
11111111111111111111111111111111
11111111111111111111111111111111
