11111111111111111111111111111111
11111111111111111111111111111111
10000000L00L00000000000000000001
11011111L01L11111110011101111111
11000000L01L00000000010101111111
11001110L00L00000110000000001111
11000000L01L00000111000000000111
10000000L11L00010000000000000001
1000000D011L11010000001100000001
11111111000111111000011000000111
11111111111111111111111111000111
11111111111000000111111000000001
10000000001001100011110000000001
10001000000000000000L11000001111
11111110000000000011L00000000001
11111000011011110011L00000000L01
10110000111000000011L01111111L01
10000000000000000011L01000111L01
10000110000000011111L11000110L01
10100000000111000000L10000000011
11100000011111111111111111111111
10000000000000000001111111111111
10000000000011111110100000000001
10000000000000100000000L00000001
11100000000000000000011L11000011
111L0000000000000000011L11000011
111L1111110011001110011L11000001
100L0000010000000000011L11000001
110L1111001000110110001L11011001
110L000000100010E110000L00011001
11111111111111111111111111111111
11111111111111111111111111111111
