11111111111111111111111111111111
11111111111111111111111111111111
110000000L0100000000011111111111
100000001L1000000000011111111111
10001D001L0011100111011111111111
100111111L0001110110011111011111
100111111L0000000000011000001111
101111111L0000000000001000001111
111111100L0000000110000000001111
11111110000011100111000000000111
11111111111110000001111111111111
11111111111011110000111111111111
10000000000000100001100000000001
10111001110000000000000000000001
101111110000L0000000000000000001
101111100000L1111100000000000001
100100000000L0000100000000000001
101000000000L0110110000000000001
101011000000L1110011000000000001
10001000001111111111011110011111
11111000001100011111111111111111
10011001110111111111100000011111
10000000100000000000000110001111
1111111011100L0000000000000000L1
1010000000011L1100001000000011L1
1000001111111L1100001011110011L1
1000000000011L1100000000000011L1
1000010000011L1100000000000011L1
1000110000001L1101100000011111L1
10011111E0100L0001100111000000L1
11111111111111111111111111111111
11111111111111111111111111111111
