11111111111111111111111111111111
11111111111111111111111111111111
10000000000111000000000000000001
10111001110110000000000000000001
1011111100011000LD11100000000001
1011111000000000L111100000000001
1001000000000000L111100000000001
1010000000001100L001100000000001
10101100000111111111100000000001
10001000001000111000111110011111
11111000001111111111111111111111
11100000000000000111111111111111
11000000000011110011100000000001
11100000111000000000001110011101
10000000000000111110001111110001
100000000L0000000000001111100001
101111111L0111000010000100000001
101000111L0111100110001000000001
111000110L0001001110001011000001
11000000001000000000000010000011
11111111111111111111111110000011
10000001111111000001110000000011
10011000111001100001001100000011
1000000000L000110000001100L00001
1000000011L010000111001111L00001
1011110011L011111111000000L00011
1000000011L001100000000111L00011
1000000011L000000000000000L00001
1000011111L000110010000000L11101
1111000000L00011E110000000L10001
11111111111111111111111111111111
11111111111111111111111111111111
