11111111111111111111111111111111
11111111111111000000011111111111
11000011111111001000000000000001
11000001101100011110001110011101
11000000101100000000001111110001
11000000001100000101101111100001
1100000000100000L10D100100000001
1000000000011111L111101000000001
1001110100100011L111101011000001
1011111101100000L001100010000011
11111111111111111111111110000011
11111111111111111111110000000011
11111111111000000000001100000011
11111111111111011111101100L00001
11111111111101011111101111L00001
11111011111000000011100000L00011
11110000011000000001100111L00011
11110000010000000000000000L00001
11110000000011000000000000L11101
11100000000110000001100000L10001
11111111111111110001111111111111
11111111111000000000000000011111
10000000000000000000000110001111
100000000000000000000000000000L1
100000000000010011110000000011L1
100000000000010011110011110011L1
100000000000010011110000000011L1
100000000000E11011110000000011L1
100000000001110000000000011111L1
111110011111111111110111000000L1
11111111111111111111111111111111
11111111111111111111111111111111
