11111111111111111111111111111111
11111111111111000011111111111111
10000000L00110000001000000000001
11011111L01010000000001110011101
11000000L0100L0000L0001111110001
11001110L0000L1111L0001111100001
11000000L0100L0000L0000100000001
10000000L1100L1111L0101000000001
1000000D01100L1111L0101011000001
1111111100010L1110L0000010000011
11111111111111111111111110000011
11111111111111111111100000000001
10000000001000000000100000000001
10001000000000100000000000000001
11111110000111111000111000000001
11111000011111100001111L00000001
10110000111011000011111L11111101
10000000000000001000000L00000101
10000110000000001000010L11110011
10100000000011111100010L00000011
11100000011111111111111111111111
11110000011111000011111111111111
100110000101100000010L0000000001
100011000000100000000L1111111001
1010000111000L0000L00L0000000001
1011111111000L1111L00L0000011001
1001100000000L0000L00L0000011101
1000000000000L1111L01L0001000001
1000110010000L1111L01L1101000001
100011E110010L1110L0011111100001
11111111111111111111111111111111
11111111111111111111111111111111
