11111111111111111111111111111111
11111111111111111111111111111111
10000000001L00000000000011100001
10001000000L11111110000000001101
11111110000L00000000000000011111
11111000011L00000110000000000001
10110000111L00000111000000000001
10000000000L00010000000001100101
10000110000L11010000000001D00101
10100000000111111000011111111111
11100000011111111111111111111111
11000000001111111111111111111111
10000000000000000000011111111111
10001000000011100111011111111111
10000000000011111100011111111111
10111000011011111000011111011111
10110000011001000000011000001111
10000000000010000000001000001111
10000110000010110000000000001111
10000000100000100000100000000111
11111111111111100000111111111111
11110000011011110000111111111111
11110000001000100001100000000001
11100000000000000000000000000001
100001111100L0000000000000000001
100000111000L1111100000000000001
101000000000L0000100000000000001
1010E0011000L0110110000000000001
111110110000L1110011000000000001
11111000010111111111011110011111
11111111111100011111111111111111
11111111111111111111111111111111
