11111111111111111111111111111111
11111111111111111111111111111111
10000000000000000000011100000001
1011100111000L000000011000000001
1011111100011L110000111000LD1111
1011111000011L110000100000L11111
1001000000011L110000000000L11111
1010000000011L110000001100L00111
1010110000001L110110011111111111
1000100000100L000110000011100011
11111000001111111111111111111111
10000000000000000111111111111111
10000000000001100011100000000011
10000000000000000000L00010000001
11100000000000000011L11111100001
111L0000000011110011L11110000111
111L1111110000000011L01100001111
100L0000010000000011L00000000001
110L1111001000011111L00001100001
110L0000001111000000L01000000001
11111111111111111111111000000111
10000000011111000011101111000011
10111111101110000001000010000111
10001000000010000000000000000001
1000000000000L0000L000L000000001
1000000000000L1111L000L111110001
1011001110000L0000L000L000010001
1000000000000L1111L010L011011001
1000110110000L1111L010L111001101
100010E110010L1110L0011111111101
11111111111111111111110001111111
11111111111111111111111111111111
