11111111111111111111111111111111
11111111111111111111111111111111
11110000000L00000000000000000011
11100000000L11111110000010000001
111000LD111L00000000011111100001
100000L1111L00000110011110000111
100000L1111L00000111001100001111
101100L0011L00010000000000000001
11111111111L11010000000001100001
10001110001111111000001000000001
11111111111111111111111000000111
11111111111111111111110000000011
10000000000000000000101100000011
10000000000000100000001100L00001
10000000000111111000001111L00001
10000000000111100001100000L00011
10000000000011000011100111L00011
10000000000000000000000000L00001
10000000000000011000000000L11101
11111001111010000000000000L10001
11111111111110000001111111111111
10000000011011110000111111111111
10111111101000100001111111111111
10001000000000000000011111111111
100000000000L0000000011111111111
100000000000L1111100011111011111
101100111000L0000100011000001111
100000000000L0110110001000001111
100011011000L1110011000000001111
100010E1100111111111000000000111
11111111111100011111111111111111
11111111111111111111111111111111
