11111111111111111111111111111111
11111111111111111111111111111111
1111000000000000000010000000L001
1110000000000010000001011111L011
111000LD11111111100001000000L011
100000L111111110000111001110L001
100000L111101100001111000000L011
101100L001100000000000000000L011
11111111111000011000000000001111
10001110001010000000011111111111
11111111111110000001111111111111
11111111111100000000111111111111
10000000000000000000111111111111
11110111111001111100011111111111
11010111111000000L00011111111111
10000000111000000L11111111011111
10000000011110000L11111000001111
10000000000111000L00001000001111
10110000000000000100000000001111
11100000011011101110000000000111
11111100011111111111111111111111
10111100001001100111011111111111
10001000011000000010000000000001
10000000000111111011100000000001
10L00000000010000000000000000001
10L11111000000001111100000000001
10L00001000000000000000000000001
10L01101100000010000000000000001
10L11100110000110000000000000001
111111111100011111E0111110011111
11000111111111111111111111111111
11111111111111111111111111111111
