11111111111111111111111111111111
10000000000111000000011111111111
10000001100111001000000000000001
110001L0100100011110001110011101
100000L0000100000000001111110001
100000L1100100000101101111100001
101110L110000000L10D100100000001
101010L110011111L111101000000001
1000000111100011L111101011000001
1000000110100000L001100010000011
11111111111111111111111110000011
11111111111111111111111000000001
11111111111000000000010000000001
11111111111111011111111000001111
11111111111101011111100000000001
11111011111000000011100000000L01
11110000011000000001101111111L01
11110000010000000000001000111L01
11110000000011000000011000110L01
11100000000110000001110000000011
11111111111111110001111111111111
11111111111111000001111111111111
100000000000011000010L0000000001
100000000000001100000L1111111001
100000000000100001110L0000000001
100000000000111111110L0000011001
100000000000011000000L0000011101
100000000000000000000L0001000001
100000000000001100100L1101000001
1111100111100011E110011111100001
11111111111111111111111111111111
11111111111111111111111111111111
