11111111111111111111111111111111
11111111111000000111111111111111
10000000L00001100011100000000001
11011111L01000000000L11101111111
11000000L01000000011L10101111111
11001110L00011110011L00000001111
11000000L01000000011L00000000111
10000000L11000000011L00000000001
1000000D011000011111L01100000001
11111111000111000000L11000000111
11111111111111111111111111000111
11111111111111111111110000000011
11111111111000000000000000000011
11111111111111011111100111110001
111111111111010111111000000L0001
111110111110000000111000000L1111
111100000110000000011110000L1111
111100000100000000000111000L0001
11110000000011000000000000010001
11100000000110000001101110111001
11111111111111110001111111111111
11111111111100000000111100001111
1000000000000000000000000000L001
1000000000000010000001011111L011
1000000000000000000001000000L011
1000000000001110000111001110L001
1000000000001100000111000000L011
1000000000000000000000000000L111
10000000000000011000000E00000111
11111001111000000010011111110001
11111111111111111111111111111111
11111111111111111111111111111111
