11111111111111111111111111111111
11111111111111111111111111111111
1111000000000000000000000000L001
1110000000011101111111011111L011
111000LD11110101111111000000L011
100000L111100000001111001110L001
100000L111100000000111000000L011
101100L001100000000000000000L011
11111111111011000000000000001111
10001110001110000001111111111111
11111111111111110001111111111111
11111111111000000000011111111111
11000000000000000000011111111111
10000000000000000000011111111111
10111001110110000000011111111111
1001110110011L000000011111011111
1000000000011L111111011000001111
1000000000000L000001001000001111
1000000110010L111100100000001111
1011100111010L000000100000000111
11100000011111111111111111111111
11110000011111111111111111111111
11110000001L00000000000000000001
11100000000L11111110000000000001
10000111110L00000000000000000001
10000011100L00000110000000000001
10100000000L00000111000000000001
1010E001100L00010000000000000001
11111011000L11010000000000000001
11111000010111111000011110011111
11111111111111111111111111111111
11111111111111111111111111111111
