11111111111111111111111111111111
11111111111111111111111111111111
10001110000000000000111111111111
10000000110000100000011111111111
10000001111111111000011111111111
10000000000111100001111111011111
10000000000011000011111000001111
10000110010000000000001000001111
100001D0010000011000000000001111
11111111111010000000000000000111
11111111111110000001111111111111
11111111111011110000111111111111
10000000000000100001100000000011
10000000000000000000000010000001
100000000000L0000000011111100001
100000000000L1111100011110000111
100000000000L0000100001100001111
100000000000L0110110000000000001
100000000000L1110011000001100001
11111001111111111111001000000001
11111111111100011111111000000111
10000001111111111111111100000111
10011000111000000000100110000101
1000000000L000100000000011000001
1000000011L111111000101000011101
1011110011L111100001101111111101
1000000011L011000011100110000001
1000000011L000001000000000000001
1000011111L000001000000011001001
1111000000L011111100000011E11001
11111111111111111111111111111111
11111111111111111111111111111111
