11111111111111111111111111111111
11111111111111111111111111111111
10000000000L0000000000000000L001
10111001110L1111111001011111L011
10111111000L0000000001000000L011
10111110000L0000011001001110L001
10010000000L0000011101000000L011
10100000000L0001000000000000L111
10101100000L110100000000000D0111
10001000001111111000011111110001
11111000001111111111111111111111
11000000001111111111111111111111
10000000001L00000000010000000001
10011111000L11111110000000000001
1000000L000L00000000001110011101
1000000L111L00000110000111011001
1110000L111L00000111000000000001
1111000L000L00010000000000000001
10000001000L11010000000000011001
10111011100111111000001110011101
11111111111111111111111000000111
11111111111000000000001111000011
10000000000000000000000010000111
10000000000000000000000000000001
1000000000000100111100L000000001
1000000000000100111100L111110001
1000000000000100111100L000010001
100000000000E110111100L011011001
1000000000011100000000L111001101
11111001111111111111011111111101
11111111111111111111110001111111
11111111111111111111111111111111
