11111111111111111111111111111111
11111111111111111111111111111111
10000000L000L0100000011111111111
11011111L011L1100000011111111111
11000000L011L0000000011111111111
11001110L000L0000000011111011111
11000000L010L0000000011000001111
10000000L110L0000100001000001111
1000000D011111000111100000001111
11111111000100000000100000000111
11111111111111000001111111111111
11111111111110000000011111111111
10000000000100000000000000000011
10000000000110000011100010000001
10000000000000000000011111100001
1000000000000000000L011110000111
1000000000001111111L001100001111
1000000000001000111L000000000001
1000000000011000110L000001100001
11111001111100000000101000000001
11111111111111111111111000000111
10000000000111111111110000000011
10000000000L00000000000000000011
10000000000L11111110000111110001
10010011110L000000000000000L0001
10010011110L000001100000000L1111
10010011110L000001110110000L1111
10E11011110L000100000111000L0001
11110000000L11010000000000010001
11111111110111111000001110111001
11111111111111111111111111111111
11111111111111111111111111111111
