11111111111111111111111111111111
11111111111111111111111111111111
1000000000000000000010000000L001
1000000000000010000001011111L011
1000000000011111100001000000L011
1000000000011110000111001110L001
1000000000001100001111000000L011
1000000000000000000000000000L111
100000000000000110000000000D0111
11111001111010000000011111110001
11111111111110000001111111111111
11111111111100000000111111111111
10000000001000000000010000011011
10001000000000100000010000011011
11111110000000000000011100011011
11111000011011100001110000011111
10110000111011000001110000001111
10000000000000000000000000000001
10000110000000011000000000000001
10100000000000000010000011110011
11100000011111111111111111111111
10000000000000000111111111111111
10000000000001100011111111111111
10000000000000000000L11111111111
10010011110000000011L11111111111
10010011110011110011L11111011111
10010011110000000011L11000001111
10E11011110000000011L01000001111
11110000000000011111L00000001111
11111111110111000000L00000000111
11111111111111111111111111111111
11111111111111111111111111111111
