11111111111111111111111111111111
11111111111111111111111111111111
10000000L00000000000011111111111
11011111L01111011111111111111111
11000000L01101011111111111111111
11001110L00000000011111111011111
11000000L01000000001111000001111
10000000L11000000000001000001111
1000000D011011000000000000001111
11111111000110000001100000000111
11111111111111110001111111111111
11111111111100000000111111111111
10L01000000011000000100000000001
11L1100000001100L000000000000001
11L0000000001111L000000000000001
10L0000000000000L000100000000001
10L0000000000111L000100000000001
10L0000100000000L000000000000001
1111000111100000L111000000000001
1100000000100000L100011110011111
11110000011111111111111111111111
10011001110111111111111111111111
100000001000000000001L0000000001
111111101110001000000L1111111001
101000000001111110001L0000000001
100000111111111000011L0000011001
100000000000110000111L0000011101
100001000000000010000L0001000001
100011000000000010000L1101000001
10011111E01011111100011111100001
11111111111111111111111111111111
11111111111111111111111111111111
