11111111111111111111111111111111
11111111111111000011111111111111
11000000000110000001010000000L01
10000000000010000000000000001L11
1011100111000L0000L000001D001L01
1001110110000L1111L0000111111L01
1000000000000L0000L0000111111L01
1000000000000L1111L0101111111L01
1000000110000L1111L0111111100L01
1011100111010L1110L0011111100001
11100000011111111111111111111111
10111100001111111111111111111111
10001000011L00000000000000000001
10000000000L11111110011101111111
10L00000000L00000000010101111111
10L11111000L00000110000000001111
10L00001000L00000111000000000111
10L01101100L00010000000000000001
10L11100110L11010000001100000001
11111111110111111000011000000111
11000111111111111111111111000111
11111111111001100111010000000011
10000000000000000010000000000001
10000000000111111011100010000001
10000000000010000000000000000001
10000000000000001111101110000111
10000000000000000000001100000111
10000000000000010000000000000001
10000000000000110000000001100001
111110011110011111E0100000001001
11111111111111111111111111111111
11111111111111111111111111111111
