11111111111111111111111111111111
11111111111111111111111111111111
10000000001000000000011100000001
1000100000000L000000011000000001
1111111000011L110000111000LD1111
1111100001111L110000100000L11111
1011000011111L110000000000L11111
1000000000011L110000001100L00111
1000011000001L110110011111111111
1010000000000L000110000011100011
11100000011111111111111111111111
10111100001111111111111111111111
100010000110L0100000011111111111
100000000001L1100000011111111111
10L000000001L0000000011111111111
10L111110000L0000000011111011111
10L000010000L0000000011000001111
10L011011000L0000100001000001111
10L11100110111000111100000001111
11111111110100000000100000000111
11000111111111000001111111111111
11111111111100000000111100000111
10000000000000000000111100000011
10000000000001111100011000000001
10000000000000000L00000001111101
10000000000000000L11100000111001
10000000000110000L11101000000001
10000000000111000L000010E0011001
10000000000000000100011110110001
11111001111011101110011110000101
11111111111111111111111111111111
11111111111111111111111111111111
