11111111111111111111111111111111
11111111111111111111111111111111
10000000000000111000000000000001
11110111111000000011011000000111
11010111111000000111111101010111
10000000111000000000011111111111
10000000011000000000011010100111
10000000000000011001000000000101
1011000000000001D001000010000111
11100000011111111111100111110001
11111100011111111111111111111111
11000000001111111111111111111111
10000000001100000000011111111111
10011111000000000000011111111111
1000000L000011100111011111111111
1000000L111001110110011111011111
1110000L111000000000011000001111
1111000L000000000000001000001111
10000001000000000110000000001111
10111011100011100111000000000111
11111111111110000001111111111111
10000001111111000001111111111111
10111100111001100001000000000001
10000000000000110000000000000001
10001111100010000111000000000001
10000000000011111111000000000001
11110000100001100000000000000001
11111001100000000000000000000001
10010011100000110010000000000001
1000000000000011E110011110011111
11111111111111111111111111111111
11111111111111111111111111111111
