11111111111111111111111111111111
11111111111111111111111111111111
10L0100000010000000L000000000001
11L1100000000000001L100000000001
11L000000000001D001L000000000001
10L0000000000111111L000000000001
10L0000000000111111L000000000001
10L0000100001111111L000000000001
1111000111111111100L000000000001
11000000001111111000011110011111
11110000011111111111111111111111
11000000001000000111111111111111
10110000001011110011110000000001
101100L0000000000000000000000001
101111L0000000111110001110011101
100000L0001000000000000111011001
100111L0001111000010000000000001
100000L0000111100110000000000001
100000L1110001001110000000011001
100000L1000000000000001110011101
11111111111111111111111000000111
10000001111000000111111100001111
1011110011100110001110000000L001
10000000000000000000L1011111L011
10001111100000000011L1000000L011
10000000000011110011L1001110L001
11110000100000000011L1000000L011
11111001100000000011L0000000L111
10010011100000011111L00E00000111
10000000000111000000L11111110001
11111111111111111111111111111111
11111111111111111111111111111111
