11111111111111111111111111111111
11111111111111000011111111111111
10000000001110000001010000000L01
10001000000010000000000000001L11
1111111000000L0000L000001D001L01
1111100001100L1111L0000111111L01
1011000011100L0000L0000111111L01
1000000000000L1111L0101111111L01
1000011000000L1111L0111111100L01
1010000000010L1110L0011111100001
11100000011111111111111111111111
11000000001111111111111111111111
10000000001L00000000000000000001
10011111000L11111110001110011101
1000000L000L00000000001111110001
1000000L111L00000110001111100001
1110000L111L00000111000100000001
1111000L000L00010000001000000001
10000001000L11010000001011000001
10111011100111111000000010000011
11111111111111111111111110000011
11111111111111000001100000000001
10000000000111000000100000000001
10000000000110000000000000000001
10000000000000011111011000000001
10000000000000001110011L00000001
10000000000010000000011L11111101
10000000000010E00110000L00000101
10000000000111101100010L11110011
11111001111111100001010L00000011
11111111111111111111111111111111
11111111111111111111111111111111
