11111111111111111111111111111111
11111111111000000111111111111111
10000000001011110011111100000001
10001000000000000000011000000001
11111110000000111110011000LD1111
11111000011000000000000000L11111
10110000111111000010000000L11111
10000000000111100110001100L00111
10000110000001001110011111111111
10100000000000000000000011100011
11100000011111111111111111111111
11100000000000000111111111111111
11000000000001100011110000000001
11100000111000000000L00000000001
10000000000000000011L01110011101
100000000L0011110011L00111011001
101111111L0000000011L00000000001
101000111L0000000011L00000000001
111000110L0000011111L00000011001
11000000001111000000L01110011101
11111111111111111111111000000111
11111111111000000111111100001111
1L00000000000110001110000000L001
1L111111100000000000L1011111L011
1L000000000000000011L1000000L011
1L000001100011110011L1001110L001
1L000001110000000011L1000000L011
1L000100000000000011L0000000L111
1L110100000000011111L00E00000111
11111110000111000000L11111110001
11111111111111111111111111111111
11111111111111111111111111111111
