11111111111111111111111111111111
11110000000111000011111111111111
11110010000110000001000000000011
11000111100010000000000010000001
1100000000000L0000L0011111100001
1100000101100L1111L0011110000111
100000L10D100L0000L0001100001111
111111L111100L1111L0100000000001
100011L111100L1111L0100001100001
100000L001110L1110L0001000000001
11111111111111111111111000000111
11111111111111000011111000000001
10L01000000110000001010000000001
11L11000000010000000011000001111
11L0000000000L0000L0000000000001
10L0000000000L1111L0000000000L01
10L0000000000L0000L0001111111L01
10L0000100000L1111L0101000111L01
1111000111100L1111L0111000110L01
1100000000110L1110L0010000000011
11110000011111111111111111111111
10000000011000000111111111111111
10111111101011110011100000000011
10001000000000000000000010000001
10000000000000111110011111100011
10000000000000000000011110000111
10110011100111000010001100001111
10000000000111100110000000100001
10001101100001001110000000100001
100010E1100000000000001111110001
11111111111111111111111111111111
11111111111111111111111111111111
