11111111111111111111111111111111
11111111111000000111111111111111
10000000001001100011111100000001
10001000000000000000L11000000001
11111110000000000011L11000LD1111
11111000011011110011L00000L11111
10110000111000000011L00000L11111
10000000000000000011L01100L00111
10000110000000011111L11111111111
10100000000111000000L00011100011
11100000011111111111111111111111
10111100001111111111111111111111
10001000011000000000011111111111
10000000000111011111111111111111
10L00000000101011111111111111111
10L11111000000000011111111011111
10L00001000000000001111000001111
10L01101100000000000001000001111
10L11100110011000000000000001111
11111111110110000001100000000111
11000111111111110001111111111111
11111111111100000000111100001111
1000000000001100000010000000L001
1000000000001100L00001011111L011
1000000000001111L00001000000L011
1000000000000000L00011001110L001
1000000000000111L00011000000L011
1000000000000000L00000000000L111
1000000000000000L111000E00000111
1111100111100000L100011111110001
11111111111111111111111111111111
11111111111111111111111111111111
