11111111111111111111111111111111
11111111111111111111111111111111
11110000000000000000111111111111
11100000000000100000011111111111
111000LD111111111000011111111111
100000L1111111100001111111011111
100000L1111011000011111000001111
101100L0011000000000001000001111
11111111111000011000000000001111
10001110001010000000000000000111
11111111111110000001111111111111
11111111111100000000111111111111
10000000000000000000110000000001
10000000000001111100000000000001
10000000000000000L00001110011101
10000000000000000L11100111011001
10000000000110000L11100000000001
10000000000111000L00000000000001
10000000000000000100000000011001
11111001111011101110001110011101
11111111111111111111111000000111
10000001111111000011110000000011
100110001110000000L0000000000001
1000000000L1011111L0100010000001
1000000011L1000000L0100000000001
1011110011L1001110L0001110000111
1000000011L1000000L0101100000111
1000000011L0000000L1100000000001
1000011111L00E000001100001100001
1111000000L111111100000000001001
11111111111111111111111111111111
11111111111111111111111111111111
