11111111111111111111111111111111
11111111111111111111111111111111
10000000001000000000111100000001
10001000000000100000011000000001
11111110000111111000111000LD1111
11111000011111100001100000L11111
10110000111011000011100000L11111
10000000000000001000001100L00111
10000110000000001000011111111111
10100000000011111100000011100011
11100000011111111111111111111111
11100000000111111111111111111111
11000000000L00000000000000000001
11100000111L11111110001110011101
10000000000L00000000001111110001
100000000L0L00000110001111100001
101111111L0L00000111000100000001
101000111L0L00010000001000000001
111000110L0L11010000001011000001
11000000001111111000000010000011
11111111111111111111111110000011
11111111111001100111000000000001
10000000000000000010000000000001
10000000000111111011100000000001
10000000000010000000011000000001
10000000000000001111111L00000001
10000000000000000000011L11111101
10000000000000010000000L00000101
10000000000000110000010L11110011
111110011110011111E0110L00000011
11111111111111111111111111111111
11111111111111111111111111111111
