11111111111111111111111111111111
11111111111000000111111111111111
10000000L00011110011100000000011
11011111L01000000000000010000001
11000000L01000111110011111100001
11001110L00000000000011110000111
11000000L01111000010001100001111
10000000L11111100110000000000001
1000000D011001001110000001100001
11111111000000000000001000000001
11111111111111111111111000000111
11111111111000000111110000000011
10L01000000011110011100000000011
11L11000000000000000000111110001
11L000000000001111100000000L0001
10L000000000000000000000000L1111
10L000000001110000100110000L1111
10L000010001111001100111000L0001
11110001111001001110000000010001
11000000001000000000001110111001
11110000011111111111111111111111
11000000001111111111111100000111
10000000001000000000100110000101
10011111000000100000000011000001
1000000L000111111000101000011101
1000000L111111100001101111111101
1110000L111011000011100110000001
1111000L000000001000000000000001
10000001000000001000000011001001
10111011100011111100000011E11001
11111111111111111111111111111111
11111111111111111111111111111111
