11111111111111111111111111111111
11111111111111111111111111111111
100000000000L0100000011100000001
100000000001L1100000011000000001
100000000001L0000000011000LD1111
100000000000L0000000000000L11111
100000000000L0000000000000L11111
100000000000L0000100001100L00111
10000000000111000111111111111111
11111001111100000000100011100011
11111111111111000001111111111111
11111111111100000000111111111111
10000000001000000000011111111111
10001000000000100000011111111111
11111110000000000000011111111111
11111000011011100001111111011111
10110000111011000001111000001111
10000000000000000000001000001111
10000110000000011000000000001111
10100000000000000010000000000111
11100000011111111111111111111111
11110000011111111111111111111111
11110000001L00000000000000000011
11100000000L11111110000010000001
10000111110L00000000011111100011
10000011100L00000110011110000111
10100000000L00000111001100001111
1010E001100L00010000000000100001
11111011000L11010000000000100001
11111000010111111000001111110001
11111111111111111111111111111111
11111111111111111111111111111111
