11111111111111111111111111111111
11111111111111111111111111111111
10000000000000111000000000000001
10111001110000000011000000000001
10111111000000000111100000000001
10111110000000000000000000000001
10010000000000000000000000000001
10100000000000011001000000000001
1010110000000001D001000000000001
10001000001111111111111110011111
11111000001111111111111111111111
11000000001111000011111111111111
10000000001110000001000000000011
10011111000010000000000010000001
1000000L00000L0000L0011111100001
1000000L11100L1111L0011110000111
1110000L11100L0000L0001100001111
1111000L00000L1111L0100000000001
1000000100000L1111L0100001100001
1011101110010L1110L0001000000001
11111111111111111111111000000111
10011001110111111111111000000001
10000000100000000000010000000001
1111111011100L000000011000001111
1010000000011L110000100000000001
1000001111111L110000100000000L01
1000000000011L110000001111111L01
1000010000011L110000001000111L01
1000110000001L110110011000110L01
10011111E0100L000110010000000011
11111111111111111111111111111111
11111111111111111111111111111111
