11111111111111111111111111111111
11110111110000000111111111111111
11110001000001100011100000000011
10000000000000000000L00010000001
10000000000000000011L11111100001
10000000000011110011L11110000111
10000000000000000011L01100001111
10000110010000000011L00000000001
100001D0010000011111L00001100001
10111111110111000000L01000000001
11111111111111111111111000000111
11111111111111111111110000000011
10000000000000000000001100000011
10000000000111011111101100L00001
10000000000101011111101111L00001
10000000000000000011100000L00011
10000000000000000001100111L00011
10000000000000000000000000L00001
10000000000011000000000000L11101
11111001111110000001100000L10001
11111111111111110001111111111111
10000001111111000001111111111111
10011000111111000000111111111111
1000000000L110000000011111111111
1000000011L000011111011111111111
1011110011L000001110011111011111
1000000011L010000000011000001111
1000000011L010E00110001000001111
1000011111L111101100000000001111
1111000000L111100001000000000111
11111111111111111111111111111111
11111111111111111111111111111111
