11111111111111111111111111111111
11111111111111111111100000000001
11110000000000000000100000011001
11100000000000100000010001L01001
111000LD111111111000000000L00001
100000L1111111100001100000L11001
100000L1111011000011101110L11001
101100L0011000000000001010L11001
11111111111000011000000000011111
10001110001010000000000000011011
11111111111110000001111111111111
11111111111100000000111111111111
1111111111101100000010L010000001
1111111111101100L00001L110000001
1111111111101111L00001L000000001
1111101111100000L00010L000000001
1111000001100111L00010L000000001
1111000001000000L00000L000010001
1111000000000000L111011100011111
1110000000000000L100010000000011
11111111111111111111111100000111
11111111111111111111111100000111
10000000000000000000011100000011
1000000000000L000000011000000001
1000000000011L110000100001111101
1000000000011L110000100000111001
1000000000011L110000001000000001
1000000000011L1100000010E0011001
1000000000001L110110011110110001
1111100111100L000110011110000101
11111111111111111111111111111111
11111111111111111111111111111111
