11111111111111111111111111111111
11110000000111111111111111111111
11110010000000000000110000000001
11000111100000100000000000000001
11000000000111111000101110011101
11000001011111100001100111011001
100000L10D1011000011100000000001
111111L1111000001000000000000001
100011L1111000001000000000011001
100000L0011011111100001110011101
11111111111111111111111000000111
11111111111000000111110000000011
10000000001011110011101100000011
10001000000000000000001100L00001
11111110000000111110001111L00001
11111000011000000000000000L00011
10110000111111000010000111L00011
10000000000111100110000000L00001
10000110000001001110000000L11101
10100000000000000000000000L10001
11100000011111111111111111111111
11000000001000000000011111111111
10000000001000000000000000000001
10011111000000000000000000000001
1000000L000001001111000000000001
1000000L111001001111000000000001
1110000L111001001111000000000001
1111000L0000E1101111000000000001
10000001000111000000000000000001
10111011100111111111011110011111
11111111111111111111111111111111
11111111111111111111111111111111
