11111111111111111111111111111111
11111111111111000011111100000001
10000000001110000001011100100001
10001000000010000000010001111001
1111111000000L0000L0010000000001
1111100001100L1111L0010000010111
1011000011100L0000L0000000L10D11
1000000000000L1111L0111111L11111
1000011000000L1111L0100011L11111
1010000000010L1110L0000000L00111
11100000011111111111111111111111
10111100001111111111111111111111
10001000011000000000011111111111
10000000000011100111011111111111
10L00000000011111100011111111111
10L11111000011111000011111011111
10L00001000001000000011000001111
10L01101100010000000001000001111
10L11100110010110000000000001111
11111111110000100000100000000111
11000111111111100000111111111111
11111111111001100111011111111111
100000000000000000100L0000000001
100000000001111110111L1111111001
100000000000100000000L0000000001
100000000000000011111L0000011001
100000000000000000000L0000011101
100000000000000100000L0001000001
100000000000001100000L1101000001
111110011110011111E0111111100001
11111111111111111111111111111111
11111111111111111111111111111111
