11111111111111111111111111111111
11111111111000000111111111111111
110000000L0001100011110000000001
100000001L1000000000L00000000001
10001D001L0000000011L01110011101
100111111L0011110011L00111011001
100111111L0000000011L00000000001
101111111L0000000011L00000000001
111111100L0000011111L00000011001
11111110000111000000L01110011101
11111111111111111111111000000111
11111111111111111111110000000011
10000000001000000000000000000001
1000100000000L000000000010000001
1111111000011L110000100000000001
1111100001111L110000101110000111
1011000011111L110000001100000111
1000000000011L110000000000000001
1000011000001L110110000001100001
1010000000000L000110000000001001
11100000011111111111111111111111
11110000011111000011100000011111
10011000010110000001001111001111
10001100000010000000000000000001
1010000111000L0000L0000011111001
1011111111000L1111L0000000000001
1001100000000L0000L0011100001001
1000000000000L1111L0111110011001
1000110010000L1111L0100100111001
100011E110010L1110L0000000000001
11111111111111111111111111111111
11111111111111111111111111111111
