11111111111111111111111111111111
11111111111111111111111111111111
10001110000000000000111111111111
10000000110000100000011111111111
10000001111111111000011111111111
10000000000111100001111111011111
10000000000011000011111000001111
10000110010000000000001000001111
100001D0010000011000000000001111
11111111111010000000000000000111
11111111111110000001111111111111
11111111111100000000111111111111
11000000000000000000100000000001
10000000000001111100000000000001
10111001110000000L00000000000001
10011101100000000L11100000000001
10000000000110000L11100000000001
10000000000111000L00000000000001
10000001100000000100000000000001
10111001110011101110011110011111
11100000011111111111111111111111
11000000001111111111111100001111
1000000000000000000000000000L001
1000100000000L00000001011111L011
1000000000011L11000011000000L011
1011100001111L11000011001110L001
1011000001111L11000001000000L011
1000000000011L11000000000000L111
1000011000001L110110000E00000111
1000000010000L000110011111110001
11111111111111111111111111111111
11111111111111111111111111111111
