11111111111111111111111111111111
11111111111000000111111111111111
11110000000011110011110000000001
11100000000000000000000000000001
111000LD111000111110001110011101
100000L1111000000000000111011001
100000L1111111000010000000000001
101100L0011111100110000000000001
11111111111001001110000000011001
10001110001000000000001110011101
11111111111111111111111000000111
11111111111111111111110000000011
10000000000L00000000000000000001
11110111111L11111110000010000001
11010111111L00000000000000000001
10000000111L00000110001110000111
10000000011L00000111001100000111
10000000000L00010000000000000001
10110000000L11010000000001100001
11100000011111111000000000001001
11111100011111111111111111111111
11000000001111000011100000000111
10110000001110000001001111111011
101100L0000010000000000010000001
101111L000000L0000L0000000000001
100000L000100L1111L0000000000001
100111L000100L0000L0001100111001
100000L000000L1111L0100000000001
100000L111000L1111L0100011011001
100000L100010L1110L0000010E11001
11111111111111111111111111111111
11111111111111111111111111111111
