11111111111111111111111111111111
11111111111111111111111111111111
10L01000000000111000000000000001
11L11000000000000011000000000001
11L00000000000000111100000000001
10L00000000000000000000000000001
10L00000000000000000000000000001
10L00001000000011001000000000001
1111000111100001D001000000000001
11000000001111111111111110011111
11110000011111111111111111111111
11000000001111111111111111111111
10000000000000000000110000000001
10001000000000100000000000000001
10000000000111111000101110011101
10111000011111100001100111011001
10110000011011000011100000000001
10000000000000001000000000000001
10000110000000001000000000011001
10000000100011111100001110011101
11111111111111111111111000000111
11111111111111111111100000000111
1L000000000000000000001111111011
1L11111110000L000000000010000001
1L00000000011L110000100000000001
1L00000110011L110000100000000001
1L00000111011L110000001100111001
1L00010000011L110000000000000001
1L11010000001L110110000011011001
1111111000000L000110000010E11001
11111111111111111111111111111111
11111111111111111111111111111111
