11111111111111111111111111111111
11111111111000000111111111111111
110000000L0011110011100000000011
100000001L1000000000000010000001
10001D001L0000111110011111100001
100111111L0000000000011110000111
100111111L0111000010001100001111
101111111L0111100110000000000001
111111100L0001001110000001100001
11111110000000000000001000000001
11111111111111111111111000000111
11111111111000000111111000000001
10000000001001100011110000000001
10001000000000000000L11000001111
11111110000000000011L00000000001
11111000011011110011L00000000L01
10110000111000000011L01111111L01
10000000000000000011L01000111L01
10000110000000011111L11000110L01
10100000000111000000L10000000011
11100000011111111111111111111111
11000000001000000001111100001111
10110000001011111110111000000101
101100L0000000100000001000000001
101111L0000000000000000L0000L001
100000L0001000000000000L1111L001
100111L0001011001110000L0000L001
100000L0000000000000000L1111L011
100000L1110000110110000L1111L011
100000L100000010E110010L1110L001
11111111111111111111111111111111
11111111111111111111111111111111
