11111111111111111111111111111111
11110000000111111111100000000001
111100100000L0100000000000011001
110001111001L1100000010001L01001
110000000001L0000000000000L00001
110000010110L0000000000000L11001
100000L10D10L0000000001110L11001
111111L11110L0000100001010L11001
100011L1111111000111100000011111
100000L0011100000000100000011011
11111111111111000001111111111111
11111111111011110000111111111111
10000000001000100001111111111111
10001000000000000000011111111111
111111100000L0000000011111111111
111110000110L1111100011111011111
101100001110L0000100011000001111
100000000000L0110110001000001111
100001100000L1110011000000001111
10100000000111111111000000000111
11100000011100011111111111111111
10000000011111111111111111111111
10111111101000000000000000000001
1000100000000L000000000000000001
1000000000011L110000100000000001
1000000000011L110000100000000001
1011001110011L110000000000000001
1000000000011L110000000000000001
1000110110001L110110000000000001
100010E110000L000110011110011111
11111111111111111111111111111111
11111111111111111111111111111111
