11111111111111111111111111111111
11111111111111111111111111111111
10000000L00000000000011111111111
11011111L01111011111111111111111
11000000L01101011111111111111111
11001110L00000000011111111011111
11000000L01000000001111000001111
10000000L11000000000001000001111
1000000D011011000000000000001111
11111111000110000001100000000111
11111111111111110001111111111111
11111111111100000000111111111111
11000000000011000000100000000001
1000000000001100L000000000000001
1011100111001111L000000000000001
1001110110000000L000100000000001
1000000000000111L000100000000001
1000000000000000L000000000000001
1000000110000000L111000000000001
1011100111000000L100011110011111
11100000011111111111111111111111
10011001110000000111100000011111
10000000100011110011100110001111
111111101110000000000000000000L1
101000000000001111100000000011L1
100000111110000000000011110011L1
100000000001110000100000000011L1
100001000001111001100000000011L1
100011000000010011100000011111L1
10011111E010000000000111000000L1
11111111111111111111111111111111
11111111111111111111111111111111
