11111111111111111111111111111111
11111111111111111111111101111101
10000000000100000000011100010001
10000000000000000000000000000001
10000000000011100111000000000001
10000000000001110110000000000001
10000000000000000000000000000001
10000000000000000000000001100101
10000000000000000110000001D00101
11111001111011100111001111111101
11111111111110000001111111111111
11111111111110000000011111111111
10000000000100000000010000111111
11110111111110000011110000011011
11010111111000000000010000001011
1000000011100000000L010000000011
1000000001101111111L010000000011
1000000000001000111L000000000001
1011000000011000110L000111010011
11100000011100000000101111110111
11111100011111111111111111111111
10011001110111111111111111111111
10000000100000000000011111111111
1111111011100L000000011111111111
1010000000011L110000111111111111
1000001111111L110000111111011111
1000000000011L110000011000001111
1000010000011L110000001000001111
1000110000001L110110000000001111
10011111E0100L000110000000000111
11111111111111111111111111111111
11111111111111111111111111111111
