11111111111111111111111111111111
11111111111000000111111111111111
1000000000101111001110000000L001
1000100000000000000001011111L011
1111111000000011111001000000L011
1111100001100000000001001110L001
1011000011111100001001000000L011
1000000000011110011000000000L111
100001100000010011100000000D0111
10100000000000000000011111110001
11100000011111111111111111111111
11000000001000000111111111111111
10000000001001100011110000000001
10011111000000000000L00000000001
1000000L000000000011L01110011101
1000000L111011110011L00111011001
1110000L111000000011L00000000001
1111000L000000000011L00000000001
10000001000000011111L00000011001
10111011100111000000L01110011101
11111111111111111111111000000111
10000001111000000111100000000001
10011000111011110011100000000001
1000000000L000000000000000000001
1000000011L000111110000100111101
1011110011L000000000000100111101
1000000011L111000010000100111101
1000000011L11110011000E110111101
1000011111L001001110011100000001
1111000000L000000000011111111101
11111111111111111111111111111111
11111111111111111111111111111111
