11111111111111111111111111111111
11111111111111111111111111111111
11110000000000000000011111111111
11100000000111011111111111111111
111000LD111101011111111111111111
100000L1111000000011111111011111
100000L1111000000001111000001111
101100L0011000000000001000001111
11111111111011000000000000001111
10001110001110000001100000000111
11111111111111110001111111111111
11111111111110000000011111111111
1000000000010000000000L010000001
1000000000011000001111L110000001
1000000000000000000001L000000001
1000000000000000000L00L000000001
1000000000001111111L00L000000001
1000000000001000111L00L000010001
1000000000011000110L011100011111
11111001111100000000110000000011
11111111111111111111111100000111
10000000011111111111100000000001
10111111101000000000000000000001
1000100000000L000000000000000001
1000000000011L110000111000000001
1000000000011L110000111L00000001
1011001110011L110000011L11111101
1000000000011L110000000L00000101
1000110110001L110110010L11110011
100010E110000L000110010L00000011
11111111111111111111111111111111
11111111111111111111111111111111
