11111111111111111111111111111111
11111111111111111111111111111111
110000000L0000000000011111111111
100000001L1111011111111111111111
10001D001L0101011111111111111111
100111111L0000000011111111011111
100111111L0000000001111000001111
101111111L0000000000001000001111
111111100L0011000000000000001111
11111110000110000001100000000111
11111111111111110001111111111111
11111111111100000000111111111111
1000000000000000000010L010000001
1000000000000111110001L110000001
10000000000000000L0001L000000001
10000000000000000L1110L000000001
10000000000110000L1110L000000001
10000000000111000L0000L000010001
10000000000000000100011100011111
11111001111011101110010000000011
11111111111111111111111100000111
11110000011111000011100000000001
11110000001110000001000000000001
11100000000010000000000000000001
1000011111000L0000L0011000000001
1000001110000L1111L0011L00000001
1010000000000L0000L0011L11111101
1010E00110000L1111L0100L00000101
1111101100000L1111L0110L11110011
1111100001010L1110L0010L00000011
11111111111111111111111111111111
11111111111111111111111111111111
