11111111111111111111111111111111
11111111111000000111111111111111
10001110000011110011100000000001
10000000110000000000011101111111
10000001111000111110010101111111
10000000000000000000000000001111
10000000000111000010000000000111
10000110010111100110000000000001
100001D0010001001110001100000001
11111111111000000000011000000111
11111111111111111111111111000111
11111111111111111111100000000001
10000000001000000000000000000001
1000100000000L000000000000000001
1111111000011L110000111000000001
1111100001111L110000111L00000001
1011000011111L110000011L11111101
1000000000011L110000000L00000101
1000011000001L110110010L11110011
1010000000000L000110010L00000011
11100000011111111111111111111111
10000000000000000111100000000111
10000000000001100011101111111011
10000000000000000000L00010000001
11100000000000000011L00000000001
111L0000000011110011L00000000001
111L1111110000000011L01100111001
100L0000010000000011L00000000001
110L1111001000011111L00011011001
110L0000001111000000L00010E11001
11111111111111111111111111111111
11111111111111111111111111111111
