11111111111111111111111111111111
11111111111111111111111111111111
11111111111000000000110000000L01
11111111111000100000000000001L11
1111111111111111100000001D001L01
11111011111111100001100111111L01
11110000011011000011100111111L01
11110000010000000000001111111L01
11110000000000011000011111100L01
11100000000010000000011111100001
11111111111110000001111111111111
11111111111000000000011111111111
10000000000000000000000000000001
10000000000000000000011101111111
10000000000110000000010101111111
1000000000011L000000000000001111
1000000000011L111111000000000111
1000000000000L000001000000000001
1000000000010L111100101100000001
1111100111110L000000111000000111
11111111111111111111111111000111
10000001111111111111100000000111
10111100111000000000101111111011
10000000000000100000000010000001
10001111100111111000100000000001
10000000000111100001100000000001
11110000100011000011101100111001
11111001100000001000000000000001
10010011100000001000000011011001
10000000000011111100000010E11001
11111111111111111111111111111111
11111111111111111111111111111111
