11111111111111111111111111111111
11111111111111111111111111111111
11110000000L00000000000000000011
11100000000L11111110000010000001
111000LD111L00000000011111100001
100000L1111L00000110011110000111
100000L1111L00000111001100001111
101100L0011L00010000000000000001
11111111111L11010000000001100001
10001110001111111000001000000001
11111111111111111111111000000111
11111111111111111111100000000001
10000000000L00000000000000000001
11110111111L11111110000000000001
11010111111L00000000011000000001
10000000111L00000110011L00000001
10000000011L00000111011L11111101
10000000000L00010000000L00000101
10110000000L11010000010L11110011
11100000011111111000010L00000011
11111100011111111111111111111111
11110000111111111111111111111111
10000000L000000000000L0000000001
11011111L0100L0000000L1111111001
11000000L0111L1100001L0000000001
11001110L0011L1100001L0000011001
11000000L0111L1100000L0000011101
10000000L1111L1100000L0001000001
100E000001101L1101100L1101000001
1111111100000L000110011111100001
11111111111111111111111111111111
11111111111111111111111111111111
