11111111111111111111111111111111
11111111111111000000011111111111
10000000001111001000010000011011
10001000000100011110010000011011
11111110000100000000011100011011
11111000011100000101110000011111
1011000011100000L10D110000001111
1000000000011111L111100000000001
1000011000000011L111100000000001
1010000000000000L001100011110011
11100000011111111111111111111111
11000000001111111111111111111111
10110000001000000000011111111111
101100L0000011100111011111111111
101111L0000011111100011111111111
100000L0001011111000011111011111
100111L0001001000000011000001111
100000L0000010000000001000001111
100000L1110010110000000000001111
100000L1000000100000100000000111
11111111111111100000111111111111
10000001111111000001111111111111
10111100111111000000100000000001
10000000000110000000000000000001
10001111100000011111000000000001
10000000000000001110000000000001
11110000100010000000000000000001
11111001100010E00110000000000001
10010011100111101100000000000001
10000000000111100001011110011111
11111111111111111111111111111111
11111111111111111111111111111111
