11111111111111111111111111111111
11111111111111111111111111111111
1111000000000000000010L010000001
1110000000000010000001L110000001
111000LD11111111100011L000000001
100000L111111110000110L000000001
100000L111101100001110L000000001
101100L001100000100000L000010001
11111111111000001000011100011111
10001110001011111100010000000011
11111111111111111111111100000111
11111111111111111111111000000001
10000000001000000000010000000001
1000100000000L000000011000001111
1111111000011L110000100000000001
1111100001111L110000100000000L01
1011000011111L110000001111111L01
1000000000011L110000001000111L01
1000011000001L110110011000110L01
1010000000000L000110010000000011
11100000011111111111111111111111
11110000011111111111111111111111
11110000001000000000100000000001
11100000000000100000000000000001
10000111110111111000100000000001
10000011100111100001100000000001
10100000000011000011100000000001
1010E001100000001000000000000001
11111011000000001000000000000001
11111000010011111100011110011111
11111111111111111111111111111111
11111111111111111111111111111111
