11111111111111111111111111111111
11111111111111111111111111111111
10000000000000111000011111111111
11110111111000000011011111111111
11010111111000000111111111111111
10000000111000000000011111011111
10000000011000000000011000001111
10000000000000011001001000001111
1011000000000001D001000000001111
11100000011111111111100000000111
11111100011111111111111111111111
10111100001111111111111111111111
10001000011000000000110000000001
10000000000000100000000000000001
10L00000000111111000101110011101
10L11111000111100001100111011001
10L00001000011000011100000000001
10L01101100000001000000000000001
10L11100110000001000000000011001
11111111110011111100001110011101
11000111111111111111111000000111
11111111111111111111111100000111
10000000000000000000011100000011
1000000000000L000000011000000001
1000000000011L110000100001111101
1000000000011L110000100000111001
1000000000011L110000001000000001
1000000000011L1100000010E0011001
1000000000001L110110011110110001
1111100111100L000110011110000101
11111111111111111111111111111111
11111111111111111111111111111111
