11111111111111111111111111111111
11111111111111111111111111111111
110000000000000000L0001001100L01
100000000001011111L01010L0011L11
101110011101000000L01011L1111L11
100111011001001110L00111L1111L11
100000000001000000L0111100011L11
100000000000000000L1111011000L11
10000001100000000D01111011011L11
10111001110111111100011000011111
11100000011111111111111111111111
11000000001111111111111111111111
10110000001000000000111111111111
101100L0000000100000011111111111
101111L0000111111000011111111111
100000L0001111100001111111011111
100111L0001011000011111000001111
100000L0000000000000001000001111
100000L1110000011000000000001111
100000L1000010000000000000000111
11111111111110000001111111111111
10000000000110000000011111111111
10000000000100000000000000000001
10000000000110000011100000000001
10010011110000000000000000000001
1001001111000000000L000000000001
1001001111001111111L000000000001
10E1101111001000111L000000000001
1111000000011000110L000000000001
11111111110100000000111110011111
11111111111111111111111111111111
11111111111111111111111111111111
