11111111111111111111111111111111
11111111111111111111111111111111
111111111110000000L0000000000011
111111111111011111L0100010000001
111111111111000000L0111111100001
111110111111001110L0011110000111
111100000111000000L0101100001111
111100000100000000L1100000000001
11110000000000000D01100001100001
11100000000111111100001000000001
11111111111111111111111000000111
11111111111111111111110000000011
10000000000100000000000000000001
10000000000000000000000010000001
10000000000011100111000000000001
10000000000001110110001110000111
10000000000000000000001100000111
10000000000000000000000000000001
10000000000000000110000001100001
11111001111011100111000000001001
11111111111110000001111111111111
10000001111000000000011111111111
10111100111000000000001001100L01
100000000000000000000010L0011L11
100011111000010011110011L1111L11
100000000000010011110111L1111L11
11110000100001001111011100011L11
111110011000E1101111011011000L11
10010011100111000000011011011L11
10000000000111111111011000011111
11111111111111111111111111111111
11111111111111111111111111111111
