11111111111111111111111111111111
11110111110111111111111111111111
1111000100000000000000000000L001
1000000000011101111111011111L011
1000000000010101111111000000L011
1000000000000000001111001110L001
1000000000000000000111000000L011
1000011001000000000000000000L011
100001D0010011000000000000001111
10111111110110000001111111111111
11111111111111110001111111111111
11111111111011110000111111111111
11111111111000100001100000000001
11111111111000000000001110011101
111111111110L0000000001111110001
111110111110L1111100001111100001
111100000110L0000100000100000001
111100000100L0110110001000000001
111100000000L1110011001011000001
11100000000111111111000010000011
11111111111100011111111110000011
11111111111111111111111100000111
10000000000000000000011100000011
1000000000000L000000011000000001
1000000000011L110000100001111101
1000000000011L110000100000111001
1000000000011L110000001000000001
1000000000011L1100000010E0011001
1000000000001L110110011110110001
1111100111100L000110011110000101
11111111111111111111111111111111
11111111111111111111111111111111
