11111111111111111111111111111111
11111111111111111111111111111111
11110000000000000000000000000001
1110000000000L000000001110011101
111000LD11111L110000101111110001
100000L111111L110000101111100001
100000L111111L110000000100000001
101100L001111L110000001000000001
1111111111101L110110001011000001
1000111000100L000110000010000011
11111111111111111111111110000011
11111111111111111111110000000011
10000000000L00000000000000000011
11110111111L11111110000111110001
11010111111L000000000000000L0001
10000000111L000001100000000L1111
10000000011L000001110110000L1111
10000000000L000100000111000L0001
10110000000L11010000000000010001
11100000011111111000001110111001
11111100011111111111111111111111
10000000000000000000011111111111
100000000000000000000L0000000001
100000000000000000000L1111111001
111000000000010011110L0000000001
111L00000000010011110L0000011001
111L11111100010011110L0000011101
100L00000100E11011110L0001000001
110L11110011110000000L1101000001
110L0000001111111111011111100001
11111111111111111111111111111111
11111111111111111111111111111111
