11111111111111111111111111111111
11110111110111111111111111111111
11110001000000000000100000000001
10000000000000100000011101111111
10000000000111111000110101111111
10000000000111100001100000001111
10000000000011000011100000000111
10000110010000001000000000000001
100001D0010000001000001100000001
10111111110011111100011000000111
11111111111111111111111111000111
11111111111111111111101111000011
10000000001000000000100010000111
10001000000000100000000000000001
1111111000011111100010L000000001
1111100001111110000110L111110001
1011000011101100001110L000010001
1000000000000000100000L011011001
1000011000000000100000L111001101
10100000000011111100011111111101
11100000011111111111110001111111
10000000000111111111111111111111
10000000000000000000100000000001
10000000000000100000000000000001
10010011110111111000100000000001
10010011110111100001100000000001
10010011110011000011100000000001
10E11011110000001000000000000001
11110000000000001000000000000001
11111111110011111100011110011111
11111111111111111111111111111111
11111111111111111111111111111111
