11111111111111111111111111111111
11111111111111111111111111111111
10L01000000000111000000000000001
11L11000000000000011000000000001
11L00000000000000111100000000001
10L00000000000000000000000000001
10L00000000000000000000000000001
10L00001000000011001000000000001
1111000111100001D001000000000001
11000000001111111111111110011111
11110000011111111111111111111111
10000000000111111111111111111111
10000000000000000000000000000011
1000000000000L000000000010000001
1110000000011L110000111111100001
111L000000011L110000111110000111
111L111111011L110000001100001111
100L000001011L110000000000000001
110L111100101L110110000001100001
110L000000100L000110001000000001
11111111111111111111111000000111
11111111111111000001100000000001
10000000000111000000100000000001
100L0000000110000000000000000001
111L1100001000011111011000000001
111L1100001000001110011L00000001
111L1100000010000000011L11111101
111L1100000010E00110000L00000101
101L1101100111101100010L11110011
100L0001100111100001010L00000011
11111111111111111111111111111111
11111111111111111111111111111111
