11111111111111111111111111111111
11111111111111111111111111111111
1000000000010000000L000000000001
1000000000000000001L111101111111
100000000000001D001L010101111111
1000000000000111111L000000001111
1000000000000111111L000000000111
1000000000001111111L000000000001
1000000000011111100L001100000001
11111001111111111000011000000111
11111111111111111111111111000111
11111111111000000111101111000011
10000000001011110011100010000111
10001000000000000000000000000001
1111111000000011111000L000000001
1111100001100000000000L111110001
1011000011111100001000L000010001
1000000000011110011000L011011001
1000011000000100111000L111001101
10100000000000000000011111111101
11100000011111111111110001111111
10000000000000000000011111111111
10000000000000000000011111111111
10000000000000000000011111111111
11100000000001001111011111111111
111L0000000001001111011111011111
111L1111110001001111011000001111
100L00000100E1101111001000001111
110L1111001111000000000000001111
110L0000001111111111000000000111
11111111111111111111111111111111
11111111111111111111111111111111
