11111111111111111111111111111111
11111111111000000111111111111111
1000000000101111001110000000L001
1000100000000000000001011111L011
1111111000000011111001000000L011
1111100001100000000001001110L001
1011000011111100001001000000L011
1000000000011110011000000000L111
100001100000010011100000000D0111
10100000000000000000011111110001
11100000011111111111111111111111
11000000001111111111111111111111
10110000001100000000011111111111
101100L0000000000000011111111111
101111L0000011100111011111111111
100000L0001001110110011111011111
100111L0001000000000011000001111
100000L0000000000000001000001111
100000L1110000000110000000001111
100000L1000011100111000000000111
11111111111110000001111111111111
11111111111001100111011111111111
100000000000000000100L0000000001
100000000001111110111L1111111001
100000000000100000000L0000000001
100000000000000011111L0000011001
100000000000000000000L0000011101
100000000000000100000L0001000001
100000000000001100000L1101000001
111110011110011111E0111111100001
11111111111111111111111111111111
11111111111111111111111111111111
