11111111111111111111111111111111
11111111111111111111100000000001
10L010000000000000L0000000011001
11L110000001011111L0110001L01001
11L000000001000000L0100000L00001
10L000000001001110L0000000L11001
10L000000001000000L0101110L11001
10L000010000000000L1101010L11001
11110001111000000D01100000011111
11000000001111111100000000011011
11110000011111111111111111111111
11100000000111111111111111111111
11000000000000000000011111111111
11100000111011100111011111111111
10000000000011111100011111111111
100000000L0011111000011111011111
101111111L0001000000011000001111
101000111L0010000000001000001111
111000110L0010110000000000001111
11000000001000100000100000000111
11111111111111100000111111111111
11111111111111000011111111111111
100000000000000000L0000000000001
100000000001011111L0100L00000001
100000000001000000L0111L11000011
100000000001001110L0011L11000011
100000000001000000L0111L11000001
100000000000000000L1111L11000001
1000000000000E000001101L11011001
11111001111111111100000L00011001
11111111111111111111111111111111
11111111111111111111111111111111
