11111111111111111111111111111111
11111111111000000111111111111111
10000000L00011110011100000000011
11011111L01000000000000010000001
11000000L01000111110011111100001
11001110L00000000000011110000111
11000000L01111000010001100001111
10000000L11111100110000000000001
1000000D011001001110000001100001
11111111000000000000001000000001
11111111111111111111111000000111
11111111111111111111101111000011
11111111111000000000100010000111
11111111111000100000000000000001
1111111111111111100000L000000001
1111101111111110000110L111110001
1111000001101100001110L000010001
1111000001000000000000L011011001
1111000000000001100000L111001101
11100000000010000000011111111101
11111111111110000001110001111111
11111111111000000000011100001111
1000000000000000000000000000L001
1000000000000000000001011111L011
1000000000011000000001000000L011
1000000000011L00000001001110L001
1000000000011L11111101000000L011
1000000000000L00000100000000L111
1000000000010L111100100E00000111
1111100111110L000000111111110001
11111111111111111111111111111111
11111111111111111111111111111111
