11111111111111111111111111111111
11111111111111000000011111111111
10000000001111001000000000000001
10001000000100011110000000000001
11111110000100000000000000000001
11111000011100000101100000000001
1011000011100000L10D100000000001
1000000000011111L111100000000001
1000011000000011L111100000000001
1010000000000000L001111110011111
11100000011111111111111111111111
10000000000111111111111111111111
10000000000000000000100000000011
10000000000000100000000010000001
11100000000111111000111111100001
111L0000000111100001111110000111
111L1111110011000011101100001111
100L0000010000001000000000000001
110L1111001000001000000001100001
110L0000001011111100001000000001
11111111111111111111111000000111
10000001111111000001111000000001
10111100111111000000110000000001
10000000000110000000011000001111
10001111100000011111000000000001
10000000000000001110000000000L01
11110000100010000000001111111L01
11111001100010E00110001000111L01
10010011100111101100011000110L01
10000000000111100001010000000011
11111111111111111111111111111111
11111111111111111111111111111111
