11111111111111111111111111111111
11111111111000000111111111111111
10001110000011110011100000000001
10000000110000000000011101111111
10000001111000111110010101111111
10000000000000000000000000001111
10000000000111000010000000000111
10000110010111100110000000000001
100001D0010001001110001100000001
11111111111000000000011000000111
11111111111111111111111111000111
11111111111000000111111000000001
10000000001011110011110000000001
10001000000000000000011000001111
11111110000000111110000000000001
11111000011000000000000000000L01
10110000111111000010001111111L01
10000000000111100110001000111L01
10000110000001001110011000110L01
10100000000000000000010000000011
11100000011111111111111111111111
10000000000111000001111111111111
10000000000111000000100000000001
10000000000110000000000L00000001
11100000000000011111011L11000011
111L0000000000001110011L11000011
111L1111110010000000011L11000001
100L0000010010E00110011L11000001
110L1111001111101100001L11011001
110L0000001111100001000L00011001
11111111111111111111111111111111
11111111111111111111111111111111
