11111111111111111111111111111111
11111111111111111111111111111111
10000000000000000000011100000001
1111011111100L000000011000000001
1101011111111L110000111000LD1111
1000000011111L110000100000L11111
1000000001111L110000000000L11111
1000000000011L110000001100L00111
1011000000001L110110011111111111
1110000001100L000110000011100011
11111100011111111111111111111111
10000000000111111111111111111111
100000000000L0100000011111111111
100000000001L1100000011111111111
111000000001L0000000011111111111
111L00000000L0000000011111011111
111L11111100L0000000011000001111
100L00000100L0000100001000001111
110L1111001111000111100000001111
110L0000001100000000100000000111
11111111111111000001111111111111
10000001111111000001111111111111
10011000111111000000100000000001
1000000000L110000000000000000001
1000000011L000011111000000000001
1011110011L000001110000000000001
1000000011L010000000000000000001
1000000011L010E00110000000000001
1000011111L111101100000000000001
1111000000L111100001011110011111
11111111111111111111111111111111
11111111111111111111111111111111
