11111111111111111111111111111111
11111111111111000011111111111111
10000000000110000001000011100001
10111001110010000000000000001101
1011111100000L0000L0000000011111
1011111000000L1111L0000000000001
1001000000000L0000L0000000000001
1010000000000L1111L0100001100101
1010110000000L1111L0100001D00101
1000100000110L1110L0011111111111
11111000001111111111111111111111
11000000001111000011111111111111
10000000001110000001000000000001
10011111000010000000011101111111
1000000L00000L0000L0010101111111
1000000L11100L1111L0000000001111
1110000L11100L0000L0000000000111
1111000L00000L1111L0100000000001
1000000100000L1111L0101100000001
1011101110010L1110L0011000000111
11111111111111111111111111000111
10000000011000000111101111000011
10111111101001100011100010000111
10001000000000000000L00000000001
10000000000000000011L0L000000001
10000000000011110011L0L111110001
10110011100000000011L0L000010001
10000000000000000011L0L011011001
10001101100000011111L0L111001101
100010E1100111000000L11111111101
11111111111111111111110001111111
11111111111111111111111111111111
