11111111111111111111111111111111
11110000000000000111111111111111
1111001000000110001110L010000001
11000111100000000000L1L110000001
11000000000000000011L1L000000001
11000001011011110011L0L000000001
100000L10D1000000011L0L000000001
111111L1111000000011L0L000010001
100011L1111000011111L11100011111
100000L0011111000000L10000000011
11111111111111111111111100000111
11111111111111111111110000000011
10000000000000000000101100000011
10000000000000100000001100L00001
10000000000111111000001111L00001
10000000000111100001100000L00011
10000000000011000011100111L00011
10000000000000000000000000L00001
10000000000000011000000000L11101
11111001111010000000000000L10001
11111111111110000001111111111111
11110000111100000000111111111111
10000000L00011000000111111111111
11011111L0101100L000011111111111
11000000L0101111L000011111111111
11001110L0000000L000111111011111
11000000L0100111L000111000001111
10000000L1100000L000001000001111
100E000001100000L111000000001111
1111111100000000L100000000000111
11111111111111111111111111111111
11111111111111111111111111111111
