11111111111111111111111111111111
11111111111111111111111111111111
10000000000000000000110000000L01
11110111111000100000000000001L11
1101011111111111100010001D001L01
10000000111111100001100111111L01
10000000011011000011100111111L01
10000000000000001000001111111L01
10110000000000001000011111100L01
11100000011011111100011111100001
11111100011111111111111111111111
11000000001000000111111111111111
1000000000101111001110L010000001
1001111100000000000001L110000001
1000000L00000011111001L000000001
1000000L11100000000000L000000001
1110000L11111100001000L000000001
1111000L00011110011000L000010001
10000001000001001110011100011111
10111011100000000000010000000011
11111111111111111111111100000111
10011001110111111111111000000001
10000000100000000000110000000001
11111110111000100000011000001111
10100000000111111000100000000001
10000011111111100001100000000L01
10000000000011000011101111111L01
10000100000000001000001000111L01
10001100000000001000011000110L01
10011111E01011111100010000000011
11111111111111111111111111111111
11111111111111111111111111111111
