11111111111111111111111111111111
11111111111111111111111111111111
11110000000L0000000000L010000001
11100000000L1111111001L110000001
111000LD111L0000000001L000000001
100000L1111L0000011000L000000001
100000L1111L0000011100L000000001
101100L0011L0001000000L000010001
11111111111L11010000011100011111
10001110001111111000010000000011
11111111111111111111111100000111
11111111111111111111101111000011
11111111111000000000100010000111
11111111111000100000000000000001
1111111111111111100000L000000001
1111101111111110000110L111110001
1111000001101100001110L000010001
1111000001000000000000L011011001
1111000000000001100000L111001101
11100000000010000000011111111101
11111111111110000001110001111111
11111111111111000001100000011111
10000000000111000000100110001111
100000000001100000000000000000L1
100000000000000111110000000011L1
100000000000000011100011110011L1
100000000000100000000000000011L1
10000000000010E001100000000011L1
100000000001111011000000011111L1
111110011111111000010111000000L1
11111111111111111111111111111111
11111111111111111111111111111111
