11111111111111111111111111111111
11111111111111000011111111111111
10L0100000011000000100000000L001
11L1100000001000000001011111L011
11L0000000000L0000L001000000L011
10L0000000000L1111L001001110L001
10L0000000000L0000L001000000L011
10L0000100000L1111L010000000L111
1111000111100L1111L01000000D0111
1100000000110L1110L0011111110001
11110000011111111111111111111111
11100000000111000011111111111111
11000000000110000001000000000011
11100000111010000000000010000001
1000000000000L0000L0011111100001
100000000L000L1111L0011110000111
101111111L000L0000L0001100001111
101000111L000L1111L0100000000001
111000110L000L1111L0100001100001
1100000000110L1110L0001000000001
11111111111111111111111000000111
11111111111111000001110000000011
1L000000000001100001000000000011
1L111111100000110000000111110001
1L0000000000100001110000000L0001
1L0000011000111111110000000L1111
1L0000011100011000000110000L1111
1L0001000000000000000111000L0001
1L110100000000110010000000010001
1111111000000011E110001110111001
11111111111111111111111111111111
11111111111111111111111111111111
