11111111111111111111111111111111
11111111111111111111111111111111
111111111110L010000000000000L001
111111111111L110000001011111L011
111111111111L000000001000000L011
111110111110L000000001001110L001
111100000110L000000001000000L011
111100000100L000010000000000L111
111100000001110001111000000D0111
11100000000100000000111111110001
11111111111111000001111111111111
11111111111110000000011111111111
10000000000100000000000000000011
10000000000110000011100010000001
10000000000000000000011111100001
1000000000000000000L011110000111
1000000000001111111L001100001111
1000000000001000111L000000000001
1000000000011000110L000001100001
11111001111100000000101000000001
11111111111111111111111000000111
11111111111111111111111100000111
10000000001000000000111100000011
10001000000000100000011000000001
11111110001111111000100001111101
11111000011111100001100000111001
10110000111011000011101000000001
100000100000000010000010E0011001
10000010000000001000011110110001
10111111000011111100011110000101
11111111111111111111111111111111
11111111111111111111111111111111
