11111111111111111111111111111111
11111111111111111111111111111111
10000000001000000000000011100001
1000100000000L000000000000001101
1111111000011L110000100000011111
1111100001111L110000100000000001
1011000011111L110000000000000001
1000000000011L110000000001100101
1000011000001L110110000001D00101
1010000000000L000110011111111111
11100000011111111111111111111111
11000000001111111111111111111111
10000000001100000000011111111111
10011111000000000000011111111111
1000000L000011100111011111111111
1000000L111001110110011111011111
1110000L111000000000011000001111
1111000L000000000000001000001111
10000001000000000110000000001111
10111011100011100111000000000111
11111111111110000001111111111111
10000000000110000000011111111111
10000000000100000000000000000001
10000000000110000011100000000001
10010011110000000000000000000001
1001001111000000000L000000000001
1001001111001111111L000000000001
10E1101111001000111L000000000001
1111000000011000110L000000000001
11111111110100000000111110011111
11111111111111111111111111111111
11111111111111111111111111111111
