11111111111111111111111111111111
11111111111111111111111111111111
10000000L000L0100000011111111111
11011111L011L1100000011111111111
11000000L011L0000000011111111111
11001110L000L0000000011111011111
11000000L010L0000000011000001111
10000000L110L0000100001000001111
1000000D011111000111100000001111
11111111000100000000100000000111
11111111111111000001111111111111
11111111111100000000111111111111
10000000000000000000000000000001
10000000000000100000011101111111
10000000000000000000010101111111
10000000000011100001100000001111
10000000000011000001100000000111
10000000000000000000000000000001
10000000000000011000001100000001
11111001111000000010011000000111
11111111111111111111111111000111
11110000011111111111110000000011
10011000010000000000001100000011
1000110000000L000000001100L00001
1010000111011L110000101111L00001
1011111111011L110000100000L00011
1001100000011L110000000111L00011
1000000000011L110000000000L00001
1000110010001L110110000000L11101
100011E110000L000110000000L10001
11111111111111111111111111111111
11111111111111111111111111111111
