11111111111111111111111111111111
11111111111111111111111101111101
10000000000000000000011100010001
10000000000111011111100000000001
10000000000101011111100000000001
10000000000000000011100000000001
10000000000000000001100000000001
10000000000000000000000001100101
10000000000011000000000001D00101
11111001111110000001101111111101
11111111111111110001111111111111
11111111111011110000111111111111
10L01000000000100001111111111111
11L11000000000000000011111111111
11L000000000L0000000011111111111
10L000000000L1111100011111011111
10L000000000L0000100011000001111
10L000010000L0110110001000001111
111100011110L1110011000000001111
11000000001111111111000000000111
11110000011100011111111111111111
11000000001001100111011111111111
10000000001000000010000000000011
10011111000111111011100010000001
1000000L000010000000011111100011
1000000L111000001111111110000111
1110000L111000000000001100001111
1111000L000000010000000000100001
10000001000000110000000000100001
101110111000011111E0101111110001
11111111111111111111111111111111
11111111111111111111111111111111
