11111111111111111111111111111111
11111111111111000000011111111111
10000000001111001000000000000001
10001000000100011110000000000001
11111110000100000000000000000001
11111000011100000101100000000001
1011000011100000L10D100000000001
1000000000011111L111100000000001
1000011000000011L111100000000001
1010000000000000L001111110011111
11100000011111111111111111111111
11000000001000000111111111111111
1011000000101111001110L010000001
101100L000000000000001L110000001
101111L000000011111001L000000001
100000L000100000000000L000000001
100111L000111100001000L000000001
100000L000011110011000L000010001
100000L1110001001110011100011111
100000L1000000000000010000000011
11111111111111111111111100000111
10000001111000000111100000000001
10111100111011110011100000000001
10000000000000000000000000000001
10001111100000111110000100111101
10000000000000000000000100111101
11110000100111000010000100111101
1111100110011110011000E110111101
10010011100001001110011100000001
10000000000000000000011111111101
11111111111111111111111111111111
11111111111111111111111111111111
