11111111111111111111111111111111
11111111111111111111111111111111
10L01000000111000000011111111111
11L11000000110000000011111111111
11L0000000011000LD11111111111111
10L0000000000000L111111111011111
10L0000000000000L111111000001111
10L0000100001100L001101000001111
11110001111111111111100000001111
11000000001000111000100000000111
11110000011111111111111111111111
11000000001111000011111111111111
1000000000111000000100L010000001
1001111100001000000001L110000001
1000000L00000L0000L001L000000001
1000000L11100L1111L000L000000001
1110000L11100L0000L000L000000001
1111000L00000L1111L010L000010001
1000000100000L1111L0111100011111
1011101110010L1110L0010000000011
11111111111111111111111100000111
11111111111111000001111000000001
10000000000001100001010000000001
10000000000000110000011000001111
10000000000010000111000000000001
10000000000011111111000000000L01
10000000000001100000001111111L01
10000000000000000000001000111L01
10000000000000110010011000110L01
1111100111100011E110010000000011
11111111111111111111111111111111
11111111111111111111111111111111
