11111111111111111111111111111111
11111111111000000111111111111111
1000000000001111001110000000L001
1011100111000000000001011111L011
1011111100000011111001000000L011
1011111000000000000001001110L001
1001000000011100001001000000L011
1010000000011110011000000000L111
101011000000010011100000000D0111
10001000001000000000011111110001
11111000001111111111111111111111
10111100001111111111111111111111
10001000011L00000000010000000001
10000000000L11111110000000000001
10L00000000L00000000001110011101
10L11111000L00000110000111011001
10L00001000L00000111000000000001
10L01101100L00010000000000000001
10L11100110L11010000000000011001
11111111110111111000001110011101
11000111111111111111111000000111
11111111111111111111100000000111
1L000000000L00000000001111111011
1L111111100L11111110000010000001
1L000000000L00000000000000000001
1L000001100L00000110000000000001
1L000001110L00000111001100111001
1L000100000L00010000000000000001
1L110100000L11010000000011011001
11111110000111111000000010E11001
11111111111111111111111111111111
11111111111111111111111111111111
