11111111111111111111111111111111
11111111111111111111111111111111
10000000000100000000010000000L01
10000000000000000000000000001L11
1000000000001110011100001D001L01
10000000000001110110000111111L01
10000000000000000000000111111L01
10000000000000000000001111111L01
10000000000000000110011111100L01
11111001111011100111011111100001
11111111111110000001111111111111
11111111111110000000011111111111
11000000000100000000011111111111
10000000000110000011111111111111
10111001110000000000011111111111
1001110110000000000L011111011111
1000000000001111111L011000001111
1000000000001000111L001000001111
1000000110011000110L000000001111
10111001110100000000100000000111
11100000011111111111111111111111
11000000001111000001100000011111
10000000001001100001000110001111
100111110000001100000000000000L1
1000000L0000100001110000000011L1
1000000L1110111111110011110011L1
1110000L1110011000000000000011L1
1111000L0000000000000000000011L1
100000010000001100100000011111L1
1011101110000011E1100111000000L1
11111111111111111111111111111111
11111111111111111111111111111111
