11111111111111111111111111111111
11111111111111111111111111111111
100000000000000000L0000000000001
100000000001011111L0101110011101
100000000001000000L0101111110001
100000000001001110L0001111100001
100000000001000000L0100100000001
100000000000000000L1101000000001
10000000000000000D01101011000001
11111001111111111100000010000011
11111111111111111111111110000011
11111111111000000111110000000011
10000000000001100011100000000011
10111001110000000000L00111110001
10111111000000000011L000000L0001
10111110000011110011L000000L1111
10010000000000000011L110000L1111
10100000000000000011L111000L0001
10101100000000011111L00000010001
10001000001111000000L01110111001
11111000001111111111111111111111
11000000001111000011111111111111
101100000010000000L0011111111111
101100L00001011111L0111111111111
101111L00001000000L0111111111111
100000L00011001110L0011111011111
100111L00011000000L0111000001111
100000L00000000000L1101000001111
100000L111000E000001100000001111
100000L1000111111100000000000111
11111111111111111111111111111111
11111111111111111111111111111111
