11111111111111111111111111111111
11111111111111111111111111111111
11110000000000000000010000111111
11100000000011100111010000011011
111000LD111011111100010000001011
100000L1111011111000010000000011
100000L1111001000000010000000011
101100L0011010000000000000000001
11111111111010110000000111010011
10001110001000100000101111110111
11111111111111100000111111111111
11111111111100000000111111111111
11111111111011000000100000000011
1111111111101100L000000010000001
1111111111101111L000011111100001
1111101111100000L000111110000111
1111000001100111L000101100001111
1111000001000000L000000000000001
1111000000000000L111000001100001
1110000000000000L100001000000001
11111111111111111111111000000111
11111111111111000011111000000001
100000000000000000L0010000000001
100000000001011111L0111000001111
100000000001000000L0100000000001
100000000001001110L0000000000L01
100000000001000000L0101111111L01
100000000000000000L1101000111L01
1000000000000E000001111000110L01
11111001111111111100010000000011
11111111111111111111111111111111
11111111111111111111111111111111
