11111111111111111111111111111111
11111111111111000011111111111111
10001110000110000001000000000001
10000000110010000000001110011101
1000000111100L0000L0001111110001
1000000000000L1111L0001111100001
1000000000000L0000L0000100000001
1000011001000L1111L0101000000001
100001D001000L1111L0101011000001
1111111111110L1110L0000010000011
11111111111111111111111110000011
11111111111111111111101111000011
10000000000L00000000000010000111
11110111111L11111110000000000001
11010111111L0000000000L000000001
10000000111L0000011000L111110001
10000000011L0000011100L000010001
10000000000L0001000000L011011001
10110000000L1101000000L111001101
11100000011111111000011111111101
11111100011111111111110001111111
11110000111000000111111111111111
10000000L00001100011100000000001
11011111L01000000000L00000000001
11000000L01000000011L00000000001
11001110L00011110011L00000000001
11000000L01000000011L00000000001
10000000L11000000011L00000000001
100E0000011000011111L00000000001
11111111000111000000L11110011111
11111111111111111111111111111111
11111111111111111111111111111111
