11111111111111111111111111111111
11111111111111111111111111111111
10000000000000111000000000000001
10000000000000000011011101111111
10000000000000000111110101111111
10000000000000000000000000001111
10000000000000000000000000000111
10000000000000011001000000000001
1000000000000001D001001100000001
11111001111111111111111000000111
11111111111111111111111111000111
11111111111000000111111000000001
10000000000011110011110000000001
10111001110000000000011000001111
10111111000000111110000000000001
10111110000000000000000000000L01
10010000000111000010001111111L01
10100000000111100110001000111L01
10101100000001001110011000110L01
10001000001000000000010000000011
11111000001111111111111111111111
11100000000111000001111111111111
110000000001110000001L0000000001
111000001111100000000L1111111001
100000000000000111110L0000000001
100000000L00000011100L0000011001
101111111L00100000000L0000011101
101000111L0010E001100L0001000001
111000110L01111011000L1101000001
11000000001111100001011111100001
11111111111111111111111111111111
11111111111111111111111111111111
