11111111111111111111111111111111
11111111111111111111111100000001
11000000000000000000011100100001
1000000000000L000000010001111001
1011100111011L110000110000000001
1001110110011L110000110000010111
1000000000011L110000000000L10D11
1000000000011L110000011111L11111
1000000110001L110110000011L11111
1011100111000L000110000000L00111
11100000011111111111111111111111
10111100001111111111111111111111
10001000011L00000000000000000001
10000000000L11111110011101111111
10L00000000L00000000010101111111
10L11111000L00000110000000001111
10L00001000L00000111000000000111
10L01101100L00010000000000000001
10L11100110L11010000001100000001
11111111110111111000011000000111
11000111111111111111111111000111
11111111111111000011110000000011
100000000000000000L0001100000011
100000000001011111L0101100L00001
100000000001000000L0101111L00001
100000000001001110L0000000L00011
100000000001000000L0100111L00011
100000000000000000L1100000L00001
1000000000000E000001100000L11101
11111001111111111100000000L10001
11111111111111111111111111111111
11111111111111111111111111111111
