11111111111111111111111111111111
11111111111111000011111111111111
10000000000110000001000011100001
11110111111010000000000000001101
1101011111100L0000L0000000011111
1000000011100L1111L0000000000001
1000000001100L0000L0000000000001
1000000000000L1111L0100001100101
1011000000000L1111L0100001D00101
1110000001110L1110L0011111111111
11111100011111111111111111111111
11000000001111111111111111111111
10110000001000000000111111111111
101100L0000000100000011111111111
101111L0000111111000011111111111
100000L0001111100001111111011111
100111L0001011000011111000001111
100000L0000000000000001000001111
100000L1110000011000000000001111
100000L1000010000000000000000111
11111111111110000001111111111111
11110000111000000000011111111111
11100000010000000000000000000001
10100000000000000000000000000001
100L0000L00001001111000000000001
100L1111L00001001111000000000001
100L0000L00001001111000000000001
100L1111L010E1101111000000000001
100L1111L01111000000000000000001
110L1110L00111111111011110011111
11111111111111111111111111111111
11111111111111111111111111111111
