11111111111111111111111111111111
11111111111111111111111111111111
11110000000100000000011111111111
11100000000000000000011111111111
111000LD111011100111011111111111
100000L1111001110110011111011111
100000L1111000000000011000001111
101100L0011000000000001000001111
11111111111000000110000000001111
10001110001011100111000000000111
11111111111110000001111111111111
11111111111000000000011111111111
10000000000000000000000000000001
10111001110000000000000000000001
10111111000110000000000000000001
1011111000011L000000000000000001
1001000000011L111111000000000001
1010000000000L000001000000000001
1010110000010L111100100000000001
1000100000110L000000111110011111
11111000001111111111111111111111
10000000011111000011100000011111
10111111101110000001001111001111
10001000000010000000000000000001
1000000000000L0000L0000011111001
1000000000000L1111L0000000000001
1011001110000L0000L0011100001001
1000000000000L1111L0111110011001
1000110110000L1111L0100100111001
100010E110010L1110L0000000000001
11111111111111111111111111111111
11111111111111111111111111111111
