11111111111111111111111111111111
11111111111111111111111111111111
11111111111111000000000000000011
11111111111110000000000010000001
1111111111111000LD11111111100001
1111101111100000L111111110000111
1111000001100000L111101100001111
1111000001001100L001100000000001
11110000000111111111100001100001
11100000000000111000101000000001
11111111111111111111111000000111
11111111111111111111111000000001
10000000000000000000110000000001
10000000000000100000011000001111
10000000000111111000000000000001
10000000000111100001100000000L01
10000000000011000011101111111L01
10000000000000000000001000111L01
10000000000000011000011000110L01
11111001111010000000010000000011
11111111111110000001111111111111
11110000011100000000111111111111
1001100001000000000000000000L001
1000110000000010000001011111L011
1010000111000000000001000000L011
1011111111001110000111001110L001
1001100000001100000111000000L011
1000000000000000000000000000L011
10001100100000011000000000001111
100011E1100000000010011111111111
11111111111111111111111111111111
11111111111111111111111111111111
