11111111111111111111111111111111
11111111111111000000000000000001
11000000000111001000000000011001
10000000000100011110010001L01001
10111001110100000000000000L00001
10011101100100000101100000L11001
1000000000000000L10D101110L11001
1000000000011111L111101010L11001
1000000110000011L111100000011111
1011100111000000L001100000011011
11100000011111111111111111111111
11100000000111111111111111111111
11000000000100000000011111111111
11100000111000000000011111111111
10000000000011100111011111111111
100000000L0001110110011111011111
101111111L0000000000011000001111
101000111L0000000000001000001111
111000110L0000000110000000001111
11000000001011100111000000000111
11111111111110000001111111111111
11111111111000000000011100000111
10000000000000000000000110000101
10000000000000000000000011000001
10000000000110000000001000011101
1000000000011L000000001111111101
1000000000011L111111000110000001
1000000000000L000001000000000001
1000000000010L111100100011001001
1111100111110L000000100011E11001
11111111111111111111111111111111
11111111111111111111111111111111
