11111111111111111111111111111111
11111111111111111111111111111111
10000000L00L00000000000000000001
11011111L01L11111110001110011101
11000000L01L00000000001111110001
11001110L00L00000110001111100001
11000000L01L00000111000100000001
10000000L11L00010000001000000001
1000000D011L11010000001011000001
11111111000111111000000010000011
11111111111111111111111110000011
11111111111000000111110000000011
10000000000001100011100000000001
10111001110000000000L00010000001
10111111000000000011L00000000001
10111110000011110011L01110000111
10010000000000000011L01100000111
10100000000000000011L00000000001
10101100000000011111L00001100001
10001000001111000000L00000001001
11111000001111111111111111111111
10000000000111111111111100000111
10000000000L00000000000110000101
10000000000L11111110000011000001
11100000000L00000000001000011101
111L0000000L00000110001111111101
111L1111110L00000111000110000001
100L0000010L00010000000000000001
110L1111001L11010000000011001001
110L0000001111111000000011E11001
11111111111111111111111111111111
11111111111111111111111111111111
