11111111111111111111111111111111
11111111111000000111111111111111
11110000000001100011100000000001
11100000000000000000L01110011101
111000LD111000000011L01111110001
100000L1111011110011L01111100001
100000L1111000000011L00100000001
101100L0011000000011L01000000001
11111111111000011111L01011000001
10001110001111000000L00010000011
11111111111111111111111110000011
11111111111111111111101111000011
100000000000L0100000000010000111
100000000001L1100000000000000001
100000000001L000000000L000000001
100000000000L000000000L111110001
100000000000L000000000L000010001
100000000000L000010000L011011001
1000000000011100011110L111001101
11111001111100000000111111111101
11111111111111000001110001111111
11110000111111000001111111111111
11100000010111000000111111111111
10100000000110000000011111111111
100L0000L00000011111011111111111
100L1111L00000001110011111011111
100L0000L00010000000011000001111
100L1111L01010E00110001000001111
100L1111L01111101100000000001111
110L1110L00111100001000000000111
11111111111111111111111111111111
11111111111111111111111111111111
