11111111111111111111111111111111
11111111111111111111111111111111
10001110000L00000000000000000001
10000000110L11111110001110011101
10000001111L00000000001111110001
10000000000L00000110001111100001
10000000000L00000111000100000001
10000110010L00010000001000000001
100001D0010L11010000001011000001
11111111111111111000000010000011
11111111111111111111111110000011
11111111111111111111101111000011
11000000000000000000100010000111
10000000000000100000000000000001
1011100111011111100010L000000001
1001110110011110000110L111110001
1000000000001100001110L000010001
1000000000000000100000L011011001
1000000110000000100000L111001101
10111001110011111100011111111101
11100000011111111111110001111111
10000000000000000111111111111111
10000000000001100011100000000001
10000000000000000000L00000000001
10010011110000000011L00000000001
10010011110011110011L00000000001
10010011110000000011L00000000001
10E11011110000000011L00000000001
11110000000000011111L00000000001
11111111110111000000L11110011111
11111111111111111111111111111111
11111111111111111111111111111111
