11111111111111111111111111111111
11111111111111111111111101111101
10000000000000000000011100010001
10000000000011100111000000000001
10000000000011111100000000000001
10000000000011111000000000000001
10000000000001000000000000000001
10000000000010000000000001100101
10000000000010110000000001D00101
11111001111000100000101111111101
11111111111111100000111111111111
11111111111000000000011111111111
10000000000000000000011111111111
10111001110000000000011111111111
10111111000110000000011111111111
1011111000011L000000011111011111
1001000000011L111111011000001111
1010000000000L000001001000001111
1010110000010L111100100000001111
1000100000110L000000100000000111
11111000001111111111111111111111
11110000011000000111111111111111
11110000001001100011100000000001
11100000000000000000L00L00000001
10000111110000000011L11L11000011
10000011100011110011L11L11000011
10100000000000000011L11L11000001
1010E001100000000011L11L11000001
11111011000000011111L01L11011001
11111000010111000000L00L00011001
11111111111111111111111111111111
11111111111111111111111111111111
