11111111111111111111111111111111
11111111111000000111111111111111
10000000L0000110001110L010000001
11011111L01000000000L1L110000001
11000000L01000000011L1L000000001
11001110L00011110011L0L000000001
11000000L01000000011L0L000000001
10000000L11000000011L0L000010001
1000000D011000011111L11100011111
11111111000111000000L10000000011
11111111111111111111111100000111
11111111111111111111111000000001
10000000001000000000110000000001
10001000000000100000011000001111
11111110000111111000100000000001
11111000011111100001100000000L01
10110000111011000011101111111L01
10000000000000001000001000111L01
10000110000000001000011000110L01
10100000000011111100010000000011
11100000011111111111111111111111
10000000011000000111111100001111
10111111101011110011111000000101
10001000000000000000001000000001
10000000000000111110000L0000L001
10000000000000000000000L1111L001
10110011100111000010000L0000L001
10000000000111100110000L1111L011
10001101100001001110000L1111L011
100010E1100000000000010L1110L001
11111111111111111111111111111111
11111111111111111111111111111111
