11111111111111111111111111111111
11111111111111000011111111111111
11110000000110000001000000000001
11100000000010000000011101111111
111000LD11100L0000L0010101111111
100000L111100L1111L0000000001111
100000L111100L0000L0000000000111
101100L001100L1111L0100000000001
1111111111100L1111L0101100000001
1000111000110L1110L0011000000111
11111111111111111111111111000111
11111111111111111111110000000011
10000000001000000000100000000001
10001000000000100000000010000001
11111110000111111000100000000001
11111000011111100001101110000111
10110000111011000011101100000111
10000000000000001000000000000001
10000110000000001000000001100001
10100000000011111100000000001001
11100000011111111111111111111111
10011001110111111111111111111111
10000000100L00000000000000000011
11111110111L11111110000010000001
10100000000L00000000011111100011
10000011111L00000110011110000111
10000000000L00000111001100001111
10000100000L00010000000000100001
10001100000L11010000000000100001
10011111E01111111000001111110001
11111111111111111111111111111111
11111111111111111111111111111111
