11111111111111111111111111111111
11111111111111111111111111111111
10000000000111000000000000000011
10000000000110000000000010000001
1000000000011000LD11111111100001
1000000000000000L111111110000111
1000000000000000L111101100001111
1000000000001100L001100000000001
10000000000111111111100001100001
11111001111000111000101000000001
11111111111111111111111000000111
11111111111111000011110000000011
10000000001110000001000000000011
10001000000010000000000111110001
1111111000000L0000L00000000L0001
1111100001100L1111L00000000L1111
1011000011100L0000L00110000L1111
1000000000000L1111L01111000L0001
1000011000000L1111L0100000010001
1010000000010L1110L0001110111001
11100000011111111111111111111111
11000000001111000001111111111111
100000000011110000001L0000000001
100111110001100000000L1111111001
1000000L0000000111110L0000000001
1000000L1110000011100L0000011001
1110000L1110100000000L0000011101
1111000L000010E001100L0001000001
100000010001111011000L1101000001
10111011100111100001011111100001
11111111111111111111111111111111
11111111111111111111111111111111
