11111111111111111111111111111111
11111111111111111111111111111111
10L01000000000000000000011100001
11L1100000000L000000000000001101
11L0000000011L110000100000011111
10L0000000011L110000100000000001
10L0000000011L110000000000000001
10L0000100011L110000000001100101
1111000111101L110110000001D00101
1100000000100L000110011111111111
11110000011111111111111111111111
11000000001000000111111111111111
10000000000001100011100000000011
10001000000000000000L00010000001
10000000000000000011L11111100001
10111000011011110011L11110000111
10110000011000000011L01100001111
10000000000000000011L00000000001
10000110000000011111L00001100001
10000000100111000000L01000000001
11111111111111111111111000000111
10000000011000000111110000000011
10111111101001100011100000000001
10001000000000000000L00010000001
10000000000000000011L00000000001
10000000000011110011L01110000111
10110011100000000011L01100000111
10000000000000000011L00000000001
10001101100000011111L00001100001
100010E1100111000000L00000001001
11111111111111111111111111111111
11111111111111111111111111111111
