11111111111111111111111111111111
11111111111111111111111111111111
10000000001L00000000000011100001
10001000000L11111110000000001101
11111110000L00000000000000011111
11111000011L00000110000000000001
10110000111L00000111000000000001
10000000000L00010000000001100101
10000110000L11010000000001D00101
10100000000111111000011111111111
11100000011111111111111111111111
10111100001111111111111111111111
10001000011L0000000000L010000001
10000000000L1111111001L110000001
10L00000000L0000000001L000000001
10L11111000L0000011000L000000001
10L00001000L0000011100L000000001
10L01101100L0001000000L000010001
10L11100110L11010000011100011111
11111111110111111000010000000011
11000111111111111111111100000111
10000001111000000001100000000001
10111100111011111110100000000001
10000000000000100000000000000001
10001111100000000000011000000001
10000000000000000000011L00000001
11110000100011001110011L11111101
11111001100000000000000L00000101
10010011100000110110010L11110011
1000000000000010E110010L00000011
11111111111111111111111111111111
11111111111111111111111111111111
