11111111111111111111111111111111
11111111111111000011111111111111
1100000000011000000100000000L001
1000000000001000000001011111L011
1011100111000L0000L001000000L011
1001110110000L1111L001001110L001
1000000000000L0000L001000000L011
1000000000000L1111L010000000L111
1000000110000L1111L01000000D0111
1011100111010L1110L0011111110001
11100000011111111111111111111111
11000000001000000111111111111111
10110000001001100011100000000001
101100L0000000000000L11101111111
101111L0000000000011L10101111111
100000L0001011110011L00000001111
100111L0001000000011L00000000111
100000L0000000000011L00000000001
100000L1110000011111L01100000001
100000L1000111000000L11000000111
11111111111111111111111111000111
11110000111000000111111100000111
11100000010001100011111100000011
10100000000000000000L11000000001
100L0000L00000000011L00001111101
100L1111L00011110011L00000111001
100L0000L00000000011L01000000001
100L1111L01000000011L010E0011001
100L1111L01000011111L11110110001
110L1110L00111000000L11110000101
11111111111111111111111111111111
11111111111111111111111111111111
