11111111111111111111111111111111
11111111111111111111111111111111
110000000L0L00000000010000000001
100000001L1L11111110000000000001
10001D001L0L00000000001110011101
100111111L0L00000110000111011001
100111111L0L00000111000000000001
101111111L0L00010000000000000001
111111100L0L11010000000000011001
11111110000111111000001110011101
11111111111111111111111000000111
11111111111111111111101111000011
11000000000000000000000010000111
1000000000000L000000000000000001
1011100111011L11000010L000000001
1001110110011L11000010L111110001
1000000000011L11000000L000010001
1000000000011L11000000L011011001
1000000110001L11011000L111001101
1011100111000L000110011111111101
11100000011111111111110001111111
11110000011111000011100000011111
10011000010110000001000110001111
100011000000100000000000000000L1
1010000111000L0000L00000000011L1
1011111111000L1111L00011110011L1
1001100000000L0000L00000000011L1
1000000000000L1111L01000000011L1
1000110010000L1111L01000011111L1
100011E110010L1110L00111000000L1
11111111111111111111111111111111
11111111111111111111111111111111
