11111111111111111111111111111111
11111111111111111111111111111111
10000000L00000000000110000111111
11011111L01000100000010000011011
11000000L01111111000010000001011
11001110L00111100001110000000011
11000000L01011000011110000000011
10000000L11000000000000000000001
1000000D011000011000000111010011
11111111000010000000001111110111
11111111111110000001111111111111
11111111111100000000111111111111
10L01000000000000000111111111111
11L11000000001111100011111111111
11L00000000000000L00011111111111
10L00000000000000L11111111011111
10L00000000110000L11111000001111
10L00001000111000L00001000001111
11110001111000000100000000001111
11000000001011101110000000000111
11110000011111111111111111111111
10000000000111111111111111111111
10000000000L00000000000000000001
10000000000L11111110000000000001
10010011110L00000000000000000001
10010011110L00000110000000000001
10010011110L00000111000000000001
10E11011110L00010000000000000001
11110000000L11010000000000000001
11111111110111111000011110011111
11111111111111111111111111111111
11111111111111111111111111111111
