11111111111111111111111111111111
11111111111111111111111111111111
10000000L00000000000110000111111
11011111L01000100000010000011011
11000000L01111111000010000001011
11001110L00111100001110000000011
11000000L01011000011110000000011
10000000L11000000000000000000001
1000000D011000011000000111010011
11111111000010000000001111110111
11111111111110000001111111111111
11111111111100000000111111111111
11111111111000000000000000000011
11111111111000100000000010000001
11111111111000000000011111100001
11111011111011100001111110000111
11110000011011000001101100001111
11110000010000000000000000000001
11110000000000011000000001100001
11100000000000000010001000000001
11111111111111111111111000000111
11111111111111000001110000000011
10000000000001100001000000000001
10000000000000110000000010000001
10000000000010000111000000000001
10000000000011111111001110000111
10000000000001100000001100000111
10000000000000000000000000000001
10000000000000110010000001100001
1111100111100011E110000000001001
11111111111111111111111111111111
11111111111111111111111111111111
