11111111111111111111111111111111
11111111111111111111111111111111
100000000000000000L0000000000001
111101111111011111L0100000000001
110101111111000000L0100000000001
100000001111001110L0000000000001
100000000111000000L0100000000001
100000000000000000L1100000000001
10110000000000000D01100000000001
11100000011111111100011110011111
11111100011111111111111111111111
11000000001000000111111111111111
10000000000011110011100000000001
10001000000000000000011101111111
10000000000000111110010101111111
10111000011000000000000000001111
10110000011111000010000000000111
10000000000111100110000000000001
10000110000001001110001100000001
10000000100000000000011000000111
11111111111111111111111111000111
11110000011111111111110000000011
11110000001L00000000001100000011
11100000000L11111110001100L00001
10000111110L00000000001111L00001
10000011100L00000110000000L00011
10100000000L00000111000111L00011
1010E001100L00010000000000L00001
11111011000L11010000000000L11101
11111000010111111000000000L10001
11111111111111111111111111111111
11111111111111111111111111111111
