11111111111111111111111111111111
11111111111111011111011111111111
10000000001111000100011111111111
10001000000000000000011111111111
11111110000000000000011111111111
11111000011000000000011111011111
10110000111000000000011000001111
10000000000000011001001000001111
1000011000000001D001000000001111
10100000000011111111000000000111
11100000011111111111111111111111
10111100001111111111111111111111
10001000011000000000000000000001
1000000000000L000000001110011101
10L0000000011L110000101111110001
10L1111100011L110000101111100001
10L0000100011L110000000100000001
10L0110110011L110000001000000001
10L1110011001L110110001011000001
1111111111000L000110000010000011
11000111111111111111111110000011
11111111111111000001100000000001
10000000000001100001000000000001
10000000000000110000000000000001
10000000000010000111011000000001
10000000000011111111011L00000001
10000000000001100000011L11111101
10000000000000000000000L00000101
10000000000000110010010L11110011
1111100111100011E110010L00000011
11111111111111111111111111111111
11111111111111111111111111111111
