11111111111111111111111111111111
11111111111111111111111111111111
10L01000000000000000000011100001
11L1100000000L000000000000001101
11L0000000011L110000100000011111
10L0000000011L110000100000000001
10L0000000011L110000000000000001
10L0000100011L110000000001100101
1111000111101L110110000001D00101
1100000000100L000110011111111111
11110000011111111111111111111111
10000000000000000111111111111111
10000000000001100011110000000001
10000000000000000000L00000000001
11100000000000000011L01110011101
111L0000000011110011L00111011001
111L1111110000000011L00000000001
100L0000010000000011L00000000001
110L1111001000011111L00000011001
110L0000001111000000L01110011101
11111111111111111111111000000111
11111111111001100111010000000011
10000000000000000010000000000011
10000000000111111011100111110001
100000000000100000000000000L0001
100000000000000011111000000L1111
100000000000000000000110000L1111
100000000000000100000111000L0001
10000000000000110000000000010001
111110011110011111E0101110111001
11111111111111111111111111111111
11111111111111111111111111111111
