11111111111111111111111111111111
11111111111111111111111101111101
10000000000000000000111100010001
10111001110000100000000000000001
10111111000111111000100000000001
10111110000111100001100000000001
10010000000011000011100000000001
10100000000000001000000001100101
10101100000000001000000001D00101
10001000001011111100001111111101
11111000001111111111111111111111
11000000001111111111111111111111
10000000000000000000011111111111
10001000000111011111111111111111
10000000000101011111111111111111
10111000011000000011111111011111
10110000011000000001111000001111
10000000000000000000001000001111
10000110000011000000000000001111
10000000100110000001100000000111
11111111111111110001111111111111
10000000000011110000111111111111
10000000000000100001100000000001
10000000000000000000000000000001
100100111100L0000000000000000001
100100111100L1111100000000000001
100100111100L0000100000000000001
10E110111100L0110110000000000001
111100000000L1110011000000000001
11111111110111111111011110011111
11111111111100011111111111111111
11111111111111111111111111111111
