11111111111111111111111111111111
11110000000111111111111111111111
11110010000000000000100000000011
11000111100000100000000010000001
11000000000111111000111111100001
11000001011111100001111110000111
100000L10D1011000011101100001111
111111L1111000001000000000000001
100011L1111000001000000001100001
100000L0011011111100001000000001
11111111111111111111111000000111
11111111111111111111110000000011
10000000000L00000000000000000011
11110111111L11111110000111110001
11010111111L000000000000000L0001
10000000111L000001100000000L1111
10000000011L000001110110000L1111
10000000000L000100000111000L0001
10110000000L11010000000000010001
11100000011111111000001110111001
11111100011111111111111111111111
10000000011111111111111111111111
10111111101L00000000000000000011
10001000000L11111110000010000001
10000000000L00000000011111100011
10000000000L00000110011110000111
10110011100L00000111001100001111
10000000000L00010000000000100001
10001101100L11010000000000100001
100010E1100111111000001111110001
11111111111111111111111111111111
11111111111111111111111111111111
