11111111111111111111111111111111
11110000000111111111111111111111
11110010000000000000000000000001
1100011110000L000000001110011101
1100000000011L110000101111110001
1100000101111L110000101111100001
100000L10D111L110000000100000001
111111L111111L110000001000000001
100011L111101L110110001011000001
100000L001100L000110000010000011
11111111111111111111111110000011
11111111111000000111110000000011
10000000001001100011100000000001
10001000000000000000L00010000001
11111110000000000011L00000000001
11111000011011110011L01110000111
10110000111000000011L01100000111
10000000000000000011L00000000001
10000110000000011111L00001100001
10100000000111000000L00000001001
11100000011111111111111111111111
10111100001000000000000000011111
10001000011000000000001111001111
10000000000000000000000000000001
10L00000000001001111000011111001
10L11111000001001111000000000001
10L00001000001001111011100001001
10L011011000E1101111011110011001
10L11100110111000000000100111001
11111111110111111111000000000001
11000111111111111111111111111111
11111111111111111111111111111111
