11111111111111111111111111111111
11111111111111111111111100000001
11000000000L00000000011100100001
10000000000L11111110010001111001
10111001110L00000000010000000001
10011101100L00000110010000010111
10000000000L00000111000000L10D11
10000000000L00010000011111L11111
10000001100L11010000000011L11111
10111001110111111000000000L00111
11100000011111111111111111111111
11100000000111111111111111111111
11000000000000000000111111111111
11100000111000100000011111111111
10000000000111111000011111111111
100000000L0111100001111111011111
101111111L0011000011111000001111
101000111L0000000000001000001111
111000110L0000011000000000001111
11000000001010000000000000000111
11111111111110000001111111111111
11111111111100000000100110011101
10000000000011000000100000001001
1000000000001100L000011111101111
1000000000001111L000001000000001
1000000000000000L000100000111111
1000000000000111L000100000000001
1000000000000000L000000001000001
1000000000000000L111000011000001
1111100111100000L10000011111E011
11111111111111111111111111111111
11111111111111111111111111111111
