11111111111111111111111111111111
11110000000111111111111111111111
11110010000100000000011111111111
11000111100000000000011111111111
11000000000011100111011111111111
11000001011001110110011111011111
100000L10D1000000000011000001111
111111L1111000000000001000001111
100011L1111000000110000000001111
100000L0011011100111000000000111
11111111111110000001111111111111
11111111111100000000111111111111
10000000000011000000100000000001
1000000000001100L000011101111111
1000000000001111L000010101111111
1000000000000000L000100000001111
1000000000000111L000100000000111
1000000000000000L000000000000001
1000000000000000L111001100000001
1111100111100000L100011000000111
11111111111111111111111111000111
10000001111111111111111100001111
1001100011100000000010000000L001
1000000000L00010000001011111L011
1000000011L11111100011000000L011
1011110011L11110000111001110L001
1000000011L01100001111000000L011
1000000011L00000100000000000L111
1000011111L000001000000E00000111
1111000000L011111100011111110001
11111111111111111111111111111111
11111111111111111111111111111111
