11111111111111111111111111111111
11111111111111111111111111111111
11110000000000000000111111111111
11100000000000100000011111111111
111000LD111111111000011111111111
100000L1111111100001111111011111
100000L1111011000011111000001111
101100L0011000000000001000001111
11111111111000011000000000001111
10001110001010000000000000000111
11111111111110000001111111111111
11111111111110000000011111111111
10000000001100000000000000000001
10001000000110000011100000000001
11111110000000000000000000000001
1111100001100000000L000000000001
1011000011101111111L000000000001
1000000000001000111L000000000001
1000011000011000110L000000000001
10100000000100000000111110011111
11100000011111111111111111111111
11000000001111000001111100001111
10000000001111000000111000000101
10011111000110000000001000000001
1000000L000000011111000L0000L001
1000000L111000001110000L1111L001
1110000L111010000000000L0000L001
1111000L000010E00110000L1111L011
10000001000111101100000L1111L011
10111011100111100001010L1110L001
11111111111111111111111111111111
11111111111111111111111111111111
