11111111111111111111111111111111
11111111111111111111111111111111
110000000L0000000000011111111111
100000001L1111011111111111111111
10001D001L0101011111111111111111
100111111L0000000011111111011111
100111111L0000000001111000001111
101111111L0000000000001000001111
111111100L0011000000000000001111
11111110000110000001100000000111
11111111111111110001111111111111
11111111111011110000111111111111
10000000000000100001100000000011
10000000000000000000000010000001
100000000000L0000000011111100001
100000000000L1111100011110000111
100000000000L0000100001100001111
100000000000L0110110000000000001
100000000000L1110011000001100001
11111001111111111111001000000001
11111111111100011111111000000111
11111111111111000001110000000011
10000000001111000000101100000011
10001000000110000000001100L00001
11111110001000011111001111L00001
11111000011000001110000000L00011
10110000111010000000000111L00011
10000010000010E00110000000L00001
10000010000111101100000000L11101
10111111000111100001000000L10001
11111111111111111111111111111111
11111111111111111111111111111111
