11111111111111111111111111111111
11110000000000000111111111111111
1111001000001111001110L010000001
1100011110000000000001L110000001
1100000000000011111001L000000001
1100000101100000000000L000000001
100000L10D111100001000L000000001
111111L111111110011000L000010001
100011L1111001001110011100011111
100000L0011000000000010000000011
11111111111111111111111100000111
11111111111000000111110000000011
10000000000001100011101100000011
11110111111000000000L01100L00001
11010111111000000011L01111L00001
10000000111011110011L00000L00011
10000000011000000011L00111L00011
10000000000000000011L00000L00001
10110000000000011111L00000L11101
11100000011111000000L00000L10001
11111100011111111111111111111111
11110000011111111111100000011111
11110000001L00000000001111001111
11100000000L11111110000000000001
10000111110L00000000000011111001
10000011100L00000110000000000001
10100000000L00000111011100001001
1010E001100L00010000011110011001
11111011000L11010000000100111001
11111000010111111000000000000001
11111111111111111111111111111111
11111111111111111111111111111111
