11111111111111111111111111111111
11111111111111111111111111111111
10001110000000000000110000000001
10000000110000100000000000000001
10000001111111111000101110011101
10000000000111100001100111011001
10000000000011000011100000000001
10000110010000001000000000000001
100001D0010000001000000000011001
11111111111011111100001110011101
11111111111111111111111000000111
11111111111111111111110000000011
100000000000L0100000001100000011
100000000001L1100000001100L00001
100000000001L0000000001111L00001
100000000000L0000000000000L00011
100000000000L0000000000111L00011
100000000000L0000100000000L00001
10000000000111000111100000L11101
11111001111100000000100000L10001
11111111111111000001111111111111
10000001111111000001111111111111
10111100111111000000111111111111
10000000000110000000011111111111
10001111100000011111011111111111
10000000000000001110011111011111
11110000100010000000011000001111
11111001100010E00110001000001111
10010011100111101100000000001111
10000000000111100001000000000111
11111111111111111111111111111111
11111111111111111111111111111111
