11111111111111111111111111111111
11111111111111111111100000000001
10000000001111000000000000011001
10001000000110000000010001L01001
1111111000011000LD11100000L00001
1111100001100000L111100000L11001
1011000011100000L111101110L11001
1000000000001100L001101010L11001
10000110000111111111100000011111
10100000000000111000100000011011
11100000011111111111111111111111
11000000001111111111111111111111
10000000000000000000111111111111
10001000000000100000011111111111
10000000000111111000011111111111
10111000011111100001111111011111
10110000011011000011111000001111
10000000000000000000001000001111
10000110000000011000000000001111
10000000100010000000000000000111
11111111111110000001111111111111
11111111111001100111011111111111
10000000001000000010000000000001
10001000000111111011100000000001
11111110001010000000000000000001
11111000011000001111100000000001
10110000111000000000000000000001
10000010000000010000000000000001
10000010000000110000000000000001
101111110000011111E0111110011111
11111111111111111111111111111111
11111111111111111111111111111111
