11111111111111111111111111111111
11111111111111111111111111111111
10001110000L00000000000000000001
10000000110L11111110001110011101
10000001111L00000000001111110001
10000000000L00000110001111100001
10000000000L00000111000100000001
10000110010L00010000001000000001
100001D0010L11010000001011000001
11111111111111111000000010000011
11111111111111111111111110000011
11111111111000000111111000000001
10000000001001100011110000000001
10001000000000000000L11000001111
11111110000000000011L00000000001
11111000011011110011L00000000L01
10110000111000000011L01111111L01
10000000000000000011L01000111L01
10000110000000011111L11000110L01
10100000000111000000L10000000011
11100000011111111111111111111111
11000000001000000111111100000111
10110000001011110011111100000011
101100L0000000000000011000000001
101111L0000000111110000001111101
100000L0001000000000000000111001
100111L0001111000010001000000001
100000L00001111001100010E0011001
100000L1110001001110011110110001
100000L1000000000000011110000101
11111111111111111111111111111111
11111111111111111111111111111111
