11111111111111111111111111111111
11111111111111000011111111111111
10000000001110000001010000000L01
10001000000010000000000000001L11
1111111000000L0000L000001D001L01
1111100001100L1111L0000111111L01
1011000011100L0000L0000111111L01
1000000000000L1111L0101111111L01
1000011000000L1111L0111111100L01
1010000000010L1110L0011111100001
11100000011111111111111111111111
11000000001111111111111111111111
10000000000L00000000000000000001
10001000000L11111110001110011101
10000000000L00000000001111110001
10111000011L00000110001111100001
10110000011L00000111000100000001
10000000000L00010000001000000001
10000110000L11010000001011000001
10000000100111111000000010000011
11111111111111111111111110000011
11110000011111111111111000000001
11110000001000000000110000000001
11100000000000100000011000001111
10000111110111111000100000000001
10000011100111100001100000000L01
10100000000011000011101111111L01
1010E001100000001000001000111L01
11111011000000001000011000110L01
11111000010011111100010000000011
11111111111111111111111111111111
11111111111111111111111111111111
