11111111111111111111111111111111
11111111111111111111111111111111
100000000000000000L000000000L001
111101111111011111L011011111L011
110101111111000000L011000000L011
100000001111001110L001001110L001
100000000111000000L011000000L011
100000000000000000L110000000L011
10110000000000000D01100000001111
11100000011111111100011111111111
11111100011111111111111111111111
11000000001111111111111111111111
10110000001000000000011111111111
101100L0000011100111011111111111
101111L0000011111100011111111111
100000L0001011111000011111011111
100111L0001001000000011000001111
100000L0000010000000001000001111
100000L1110010110000000000001111
100000L1000000100000100000000111
11111111111111100000111111111111
11111111111000000000011100000111
10000000000000000000011100000011
10000000000000000000011000000001
10000000000110000000000001111101
1000000000011L000000000000111001
1000000000011L111111001000000001
1000000000000L0000010010E0011001
1000000000010L111100111110110001
1111100111110L000000111110000101
11111111111111111111111111111111
11111111111111111111111111111111
