11111111111111111111111111111111
11111111111111111111111111111111
100000000000000000L0000000000011
100000000001011111L0100010000001
100000000001000000L0111111100001
100000000001001110L0011110000111
100000000001000000L0101100001111
100000000000000000L1100000000001
10000000000000000D01100001100001
11111001111111111100001000000001
11111111111111111111111000000111
11111111111111000011111000000001
10000000001110000001010000000001
10001000000010000000011000001111
1111111000000L0000L0000000000001
1111100001100L1111L0000000000L01
1011000011100L0000L0001111111L01
1000000000000L1111L0101000111L01
1000011000000L1111L0111000110L01
1010000000010L1110L0010000000011
11100000011111111111111111111111
10011001110111000011111111111111
10000000100110000001000000000001
11111110111010000000000L00000001
1010000000000L0000L0011L11000011
1000001111100L1111L0011L11000011
1000000000000L0000L0011L11000001
1000010000000L1111L0111L11000001
1000110000000L1111L0101L11011001
10011111E0110L1110L0000L00011001
11111111111111111111111111111111
11111111111111111111111111111111
