11111111111111111111111111111111
11111111111111111111111111111111
1000000000010000000L000000000011
1000000000000000001L100010000001
100000000000001D001L011111100001
1000000000000111111L011110000111
1000000000000111111L001100001111
1000000000001111111L000000000001
1000000000011111100L000001100001
11111001111111111000001000000001
11111111111111111111111000000111
11111111111111111111100000000001
11000000000L00000000000000000001
10000000000L11111110000000000001
10111001110L00000000011000000001
10011101100L00000110011L00000001
10000000000L00000111011L11111101
10000000000L00010000000L00000101
10000001100L11010000010L11110011
10111001110111111000010L00000011
11100000011111111111111111111111
11000000001111000001111111111111
10000000000111000000100000000011
10001000000110000000000010000001
10000000000000011111011111100011
10111000011000001110011110000111
10110000011010000000001100001111
10000000000010E00110000000100001
10000110000111101100000000100001
10000000100111100001001111110001
11111111111111111111111111111111
11111111111111111111111111111111
