11111111111111111111111111111111
11111111111000000111111111111111
10000000L00011110011100000000001
11011111L01000000000001110011101
11000000L01000111110001111110001
11001110L00000000000001111100001
11000000L01111000010000100000001
10000000L11111100110001000000001
1000000D011001001110001011000001
11111111000000000000000010000011
11111111111111111111111110000011
11111111111111111111100000000001
10000000001000000000100000000001
10001000000000100000000000000001
11111110000111111000111000000001
11111000011111100001111L00000001
10110000111011000011111L11111101
10000000000000001000000L00000101
10000110000000001000010L11110011
10100000000011111100010L00000011
11100000011111111111111111111111
10000000000111111111100110011101
10000000000000000000100000001001
10000000000000100000011111101111
11100000000111111000101000000001
111L0000000111100001100000111111
111L1111110011000011100000000001
100L0000010000001000000001000001
110L1111001000001000000011000001
110L000000101111110000011111E011
11111111111111111111111111111111
11111111111111111111111111111111
