11111111111111111111111111111111
11111111111111111111111101111101
111111111110L0100000011100010001
111111111111L1100000000000000001
111111111111L0000000000000000001
111110111110L0000000000000000001
111100000110L0000000000000000001
111100000100L0000100000001100101
11110000000111000111100001D00101
11100000000100000000101111111101
11111111111111000001111111111111
11111111111110000000011111111111
10000000000100000000000000000001
10000000000110000011101110011101
10000000000000000000001111110001
1000000000000000000L001111100001
1000000000001111111L000100000001
1000000000001000111L001000000001
1000000000011000110L001011000001
11111001111100000000100010000011
11111111111111111111111110000011
10000001111111000011100110011101
10111100111110000001000000001001
10000000000010000000011111101111
1000111110000L0000L0001000000001
1000000000000L1111L0000000111111
1111000010000L0000L0000000000001
1111100110000L1111L0100001000001
1001001110000L1111L0100011000001
1000000000010L1110L000011111E011
11111111111111111111111111111111
11111111111111111111111111111111
