11111111111111111111111111111111
11111111111111111111111111111111
11000000000000111000000000000001
10000000000000000011000000000001
10111001110000000111100000000001
10011101100000000000000000000001
10000000000000000000000000000001
10000000000000011001000000000001
1000000110000001D001000000000001
10111001110111111111111110011111
11100000011111111111111111111111
11000000001111111111111111111111
10000000000L00000000000000000011
10001000000L11111110000010000001
10000000000L00000000011111100001
10111000011L00000110011110000111
10110000011L00000111001100001111
10000000000L00010000000000000001
10000110000L11010000000001100001
10000000100111111000001000000001
11111111111111111111111000000111
11110000011111111111111000000001
11110000001000000000010000000001
1110000000000L000000011000001111
1000011111011L110000100000000001
1000001110011L110000100000000L01
1010000000011L110000001111111L01
1010E00110011L110000001000111L01
1111101100001L110110011000110L01
1111100001000L000110010000000011
11111111111111111111111111111111
11111111111111111111111111111111
