11111111111111111111111111111111
11110000000111111111111111111111
11110010000000000000011111111111
11000111100011100111011111111111
11000000000011111100011111111111
11000001011011111000011111011111
100000L10D1001000000011000001111
111111L1111010000000001000001111
100011L1111010110000000000001111
100000L0011000100000100000000111
11111111111111100000111111111111
11111111111100000000111111111111
10000000000011000000100000000011
1000000000001100L000000010000001
1000000000001111L000011111100001
1000000000000000L000111110000111
1000000000000111L000101100001111
1000000000000000L000000000000001
1000000000000000L111000001100001
1111100111100000L100001000000001
11111111111111111111111000000111
10000001111000000000010000000011
10011000111000000000001100000011
1000000000L000000000001100L00001
1000000011L001001111001111L00001
1011110011L001001111000000L00011
1000000011L001001111000111L00011
1000000011L0E1101111000000L00001
1000011111L111000000000000L11101
1111000000L111111111000000L10001
11111111111111111111111111111111
11111111111111111111111111111111
