11111111111111111111111111111111
11111111111111000011111111111111
10000000001110000001010000000L01
10001000000010000000000000001L11
1111111000000L0000L000001D001L01
1111100001100L1111L0000111111L01
1011000011100L0000L0000111111L01
1000000000000L1111L0101111111L01
1000011000000L1111L0111111100L01
1010000000010L1110L0011111100001
11100000011111111111111111111111
10000000000111111111111111111111
10000000000L00000000000000000011
10000000000L11111110000010000001
11100000000L00000000011111100001
111L0000000L00000110011110000111
111L1111110L00000111001100001111
100L0000010L00010000000000000001
110L1111001L11010000000001100001
110L0000001111111000001000000001
11111111111111111111111000000111
11111111111000000111100000000111
10000000000001100011101111111011
10000000000000000000L00010000001
10000000000000000011L00000000001
10000000000011110011L00000000001
10000000000000000011L01100111001
10000000000000000011L00000000001
10000000000000011111L00011011001
11111001111111000000L00010E11001
11111111111111111111111111111111
11111111111111111111111111111111
