11111111111111111111111111111111
10000000000111111111111111111111
1000000110010000000L010000000001
110001L010000000001L100000000001
100000L00000001D001L001110011101
100000L110000111111L000111011001
101110L110000111111L000000000001
101010L110001111111L000000000001
1000000111111111100L000000011001
10000001101111111000001110011101
11111111111111111111111000000111
11111111111111111111111000000001
11111111111000000000110000000001
11111111111000100000011000001111
11111111111111111000000000000001
11111011111111100001100000000L01
11110000011011000011101111111L01
11110000010000000000001000111L01
11110000000000011000011000110L01
11100000000010000000010000000011
11111111111110000001111111111111
11111111111111000001100000011111
10000000000111000000101111001111
10000000000110000000000000000001
10000000000000011111000011111001
10000000000000001110000000000001
10000000000010000000011100001001
10000000000010E00110011110011001
10000000000111101100000100111001
11111001111111100001000000000001
11111111111111111111111111111111
11111111111111111111111111111111
