11111111111111111111111111111111
11111111111111111111111111111111
10000000L0000000000010000000L001
11011111L0100010000001011111L011
11000000L0111111100001000000L011
11001110L0011110000111001110L001
11000000L0101100001111000000L011
10000000L1100000000000000000L011
1000000D011000011000000000001111
11111111000010000000011111111111
11111111111110000001111111111111
11111111111100000000111111111111
11111111111000000000000000000011
11111111111000100000000010000001
11111111111000000000011111100001
11111011111011100001111110000111
11110000011011000001101100001111
11110000010000000000000000000001
11110000000000011000000001100001
11100000000000000010001000000001
11111111111111111111111000000111
11111111111000000111100000000111
10000000000001100011101111111011
10000000000000000000L00010000001
10000000000000000011L00000000001
10000000000011110011L00000000001
10000000000000000011L01100111001
10000000000000000011L00000000001
10000000000000011111L00011011001
11111001111111000000L00010E11001
11111111111111111111111111111111
11111111111111111111111111111111
