11111111111111111111111111111111
11110000000111111111111111111111
11110010000000000000011111111111
11000111100011100111011111111111
11000000000011111100011111111111
11000001011011111000011111011111
100000L10D1001000000011000001111
111111L1111010000000001000001111
100011L1111010110000000000001111
100000L0011000100000100000000111
11111111111111100000111111111111
11111111111110000000011111111111
10000000000100000000000000000001
10000000000110000011111101111111
10000000000000000000010101111111
1000000000000000000L000000001111
1000000000001111111L000000000111
1000000000001000111L000000000001
1000000000011000110L001100000001
11111001111100000000111000000111
11111111111111111111111111000111
11110000111000000000010000000011
11100000010000000000000000000011
10100000000000000000000111110001
100L0000L000010011110000000L0001
100L1111L000010011110000000L1111
100L0000L000010011110110000L1111
100L1111L010E11011110111000L0001
100L1111L01111000000000000010001
110L1110L00111111111001110111001
11111111111111111111111111111111
11111111111111111111111111111111
