11111111111111111111111111111111
11111111111111111111111101111101
10000000000000000000111100010001
11100000011000100000000000000001
11110101011111111000000000000001
11111111111111100001100000000001
11101010011011000011100000000001
10000000010000000000000001100101
10001000011000011000000001D00101
10011111000010000000001111111101
11111111111110000001111111111111
11111111111000000000011111111111
11111111111000000000000000000001
11111111111000000000011101111111
11111111111110000000010101111111
1111101111111L000000000000001111
1111000001111L111111000000000111
1111000001000L000001000000000001
1111000000010L111100101100000001
1110000000010L000000111000000111
11111111111111111111111111000111
11111111111111111111111100000111
10000000000L00000000011100000011
10000000000L11111110011000000001
10000000000L00000000000001111101
10000000000L00000110000000111001
10000000000L00000111001000000001
10000000000L000100000010E0011001
10000000000L11010000011110110001
11111001111111111000011110000101
11111111111111111111111111111111
11111111111111111111111111111111
