11111111111111111111111111111111
11111111111111111111111111111111
10001110000000000000010000000001
1000000011000L000000000000000001
1000000111111L110000101110011101
1000000000011L110000100111011001
1000000000011L110000000000000001
1000011001011L110000000000000001
100001D001001L110110000000011001
1111111111100L000110001110011101
11111111111111111111111000000111
11111111111111111111111000000001
111111111110L0100000010000000001
111111111111L1100000011000001111
111111111111L0000000000000000001
111110111110L0000000000000000L01
111100000110L0000000001111111L01
111100000100L0000100001000111L01
11110000000111000111111000110L01
11100000000100000000110000000011
11111111111111000001111111111111
11111111111000000001111100001111
10000000000011111110111000000101
10000000000000100000001000000001
10000000000000000000000L0000L001
10000000000000000000000L1111L001
10000000000011001110000L0000L001
10000000000000000000000L1111L011
10000000000000110110000L1111L011
1111100111100010E110010L1110L001
11111111111111111111111111111111
11111111111111111111111111111111
