11111111111111111111111111111111
11111111111111111111111101111101
11111111111000000000011100010001
11111111111111011111100000000001
11111111111101011111100000000001
11111011111000000011100000000001
11110000011000000001100000000001
11110000010000000000000001100101
11110000000011000000000001D00101
11100000000110000001101111111101
11111111111111110001111111111111
11111111111110000000011111111111
10000000000100000000010000000001
10000000000110000011100000000001
10000000000000000000001110011101
1000000000000000000L000111011001
1000000000001111111L000000000001
1000000000001000111L000000000001
1000000000011000110L000000011001
11111001111100000000101110011101
11111111111111111111111000000111
11110000111111111111100000000001
10000000L00000000000100000000001
11011111L01000100000000000000001
11000000L01111111000111000000001
11001110L00111100001111L00000001
11000000L01011000011111L11111101
10000000L11000001000000L00000101
100E0000011000001000010L11110011
11111111000011111100010L00000011
11111111111111111111111111111111
11111111111111111111111111111111
