11111111111111111111111111111111
11111111111111111111100000000001
1000000000010000000L000000011001
1011100111000000001L110001L01001
101111110000001D001L000000L00001
1011111000000111111L000000L11001
1001000000000111111L001110L11001
1010000000001111111L001010L11001
1010110000011111100L000000011111
10001000001111111000000000011011
11111000001111111111111111111111
11000000001111111111111111111111
10000000000000000000011111111111
10001000000111011111111111111111
10000000000101011111111111111111
10111000011000000011111111011111
10110000011000000001111000001111
10000000000000000000001000001111
10000110000011000000000000001111
10000000100110000001100000000111
11111111111111110001111111111111
11110000011100000000111111111111
11110000001011000000100000000001
1110000000001100L000000000000001
1000011111001111L000000000000001
1000001110000000L000100000000001
1010000000000111L000100000000001
1010E00110000000L000000000000001
1111101100000000L111000000000001
1111100001000000L100011110011111
11111111111111111111111111111111
11111111111111111111111111111111
