11111111111111111111111111111111
11111111111111111111111111111111
11110000000L00000000000000000011
11100000000L11111110000010000001
111000LD111L00000000011111100001
100000L1111L00000110011110000111
100000L1111L00000111001100001111
101100L0011L00010000000000000001
11111111111L11010000000001100001
10001110001111111000001000000001
11111111111111111111111000000111
11111111111111111111100000000001
10000000000000000000100000000001
10111001110000100000000000000001
10111111000111111000111000000001
10111110000111100001111L00000001
10010000000011000011111L11111101
10100000000000001000000L00000101
10101100000000001000010L11110011
10001000001011111100010L00000011
11111000001111111111111111111111
10111100001000000111100110011101
10001000011001100011100000001001
10000000000000000000L11111101111
10L00000000000000011L01000000001
10L11111000011110011L00000111111
10L00001000000000011L00000000001
10L01101100000000011L00001000001
10L11100110000011111L00011000001
11111111110111000000L0011111E011
11000111111111111111111111111111
11111111111111111111111111111111
