11111111111111111111111111111111
11111111111111111111111111111111
10001110000L00000000010000000001
10000000110L11111110000000000001
10000001111L00000000001110011101
10000000000L00000110000111011001
10000000000L00000111000000000001
10000110010L00010000000000000001
100001D0010L11010000000000011001
11111111111111111000001110011101
11111111111111111111111000000111
11111111111111111111101111000011
10000000000000000000000010000111
10000000000111011111100000000001
1000000000010101111110L000000001
1000000000000000001110L111110001
1000000000000000000110L000010001
1000000000000000000000L011011001
1000000000001100000000L111001101
11111001111110000001111111111101
11111111111111110001110001111111
11110000111011110000111111111111
10000000L00000100001111111111111
11011111L01000000000011111111111
11000000L010L0000000011111111111
11001110L000L1111100011111011111
11000000L010L0000100011000001111
10000000L110L0110110001000001111
100E00000110L1110011000000001111
11111111000111111111000000000111
11111111111100011111111111111111
11111111111111111111111111111111
