11111111111111111111111111111111
10000000000111111111111111111111
10000001100000111000010000000001
110001L0100000000011000000000001
100000L0000000000111101110011101
100000L1100000000000000111011001
101110L1100000000000000000000001
101010L1100000011001000000000001
1000000111100001D001000000011001
10000001101111111111101110011101
11111111111111111111111000000111
11111111111111111111110000000011
11111111111000000000100000000001
11111111111000100000000010000001
11111111111111111000000000000001
11111011111111100001101110000111
11110000011011000011101100000111
11110000010000000000000000000001
11110000000000011000000001100001
11100000000010000000000000001001
11111111111110000001111111111111
11111111111000000000011111111111
100000000000000000000L0000000001
100000000000000000000L1111111001
100000000000010011110L0000000001
100000000000010011110L0000011001
100000000000010011110L0000011101
100000000000E11011110L0001000001
100000000001110000000L1101000001
11111001111111111111011111100001
11111111111111111111111111111111
11111111111111111111111111111111
