11111111111111111111111111111111
11111111111111111111111111111111
10001110000000000000100000000001
10000000110000100000011000000111
10000001111111111000011101010111
10000000000111100001111111111111
10000000000011000011111010100111
10000110010000000000000000000101
100001D0010000011000000010000111
11111111111010000000000111110001
11111111111110000001111111111111
11111111111011110000111111111111
1111111111100010000110L010000001
1111111111100000000001L110000001
111111111110L000000001L000000001
111110111110L111110000L000000001
111100000110L000010000L000000001
111100000100L011011000L000010001
111100000000L1110011011100011111
11100000000111111111010000000011
11111111111100011111111100000111
11111111111000000000010000000011
10000000000000000000001100000011
10000000000000000000001100L00001
10000000000001001111001111L00001
10000000000001001111000000L00011
10000000000001001111000111L00011
100000000000E1101111000000L00001
10000000000111000000000000L11101
11111001111111111111000000L10001
11111111111111111111111111111111
11111111111111111111111111111111
