11111111111111111111111111111111
11111111111111011111011111111111
10L01000000111000100010000111111
11L11000000000000000010000011011
11L00000000000000000010000001011
10L00000000000000000010000000011
10L00000000000000000010000000011
10L00001000000011001000000000001
1111000111100001D001000111010011
11000000001011111111001111110111
11110000011111111111111111111111
11000000001111111111111111111111
10000000001000000000111111111111
10011111000000100000011111111111
1000000L000111111000011111111111
1000000L111111100001111111011111
1110000L111011000011111000001111
1111000L000000000000001000001111
10000001000000011000000000001111
10111011100010000000000000000111
11111111111110000001111111111111
11111111111100000000100000000111
10000000000011000000101111111011
1000000000001100L000000010000001
1000000000001111L000000000000001
1000000000000000L000100000000001
1000000000000111L000101100111001
1000000000000000L000000000000001
1000000000000000L111000011011001
1111100111100000L100000010E11001
11111111111111111111111111111111
11111111111111111111111111111111
