11111111111111111111111111111111
11111111111111111111111111111111
11110000000000000000111111111111
11100000000000100000011111111111
111000LD111111111000011111111111
100000L1111111100001111111011111
100000L1111011000011111000001111
101100L0011000000000001000001111
11111111111000011000000000001111
10001110001010000000000000000111
11111111111110000001111111111111
11111111111110000000011111111111
10000000000100000000000000000001
10000000000110000011111101111111
10000000000000000000010101111111
1000000000000000000L000000001111
1000000000001111111L000000000111
1000000000001000111L000000000001
1000000000011000110L001100000001
11111001111100000000111000000111
11111111111111111111111111000111
11111111111000000000010000000011
10000000000000000000001100000011
100L0000000000000000001100L00001
111L1100001001001111001111L00001
111L1100001001001111000000L00011
111L1100000001001111000111L00011
111L11000000E1101111000000L00001
101L1101100111000000000000L11101
100L0001100111111111000000L10001
11111111111111111111111111111111
11111111111111111111111111111111
