11111111111111111111111111111111
11111111111111000000011111111111
10000000000111001000000000000001
10111001110100011110000000000001
10111111000100000000000000000001
10111110000100000101100000000001
1001000000000000L10D100000000001
1010000000011111L111100000000001
1010110000000011L111100000000001
1000100000100000L001111110011111
11111000001111111111111111111111
11000000001000000111111111111111
1000000000101111001110L010000001
1001111100000000000001L110000001
1000000L00000011111001L000000001
1000000L11100000000000L000000001
1110000L11111100001000L000000001
1111000L00011110011000L000010001
10000001000001001110011100011111
10111011100000000000010000000011
11111111111111111111111100000111
11111111111111111111100110011101
10000000000000000000100000001001
100L0000000000100000011111101111
111L1100001111111000101000000001
111L1100001111100001100000111111
111L1100000011000011100000000001
111L1100000000001000000001000001
101L1101100000001000000011000001
100L000110001111110000011111E011
11111111111111111111111111111111
11111111111111111111111111111111
