11111111111111111111111111111111
11111111111000000111111111111111
11110000000011110011100000000011
11100000000000000000000010000001
111000LD111000111110011111100001
100000L1111000000000011110000111
100000L1111111000010001100001111
101100L0011111100110000000000001
11111111111001001110000001100001
10001110001000000000001000000001
11111111111111111111111000000111
11111111111000000111100000000001
11000000000001100011100000000001
10000000000000000000L00000000001
10111001110000000011L11000000001
10011101100011110011L11L00000001
10000000000000000011L11L11111101
10000000000000000011L00L00000101
10000001100000011111L10L11110011
10111001110111000000L10L00000011
11100000011111111111111111111111
11000000001111111111100000000111
10000000000000000000101111111011
10001000000000100000000010000001
10000000000111111000100000000001
10111000011111100001100000000001
10110000011011000011101100111001
10000000000000001000000000000001
10000110000000001000000011011001
10000000100011111100000010E11001
11111111111111111111111111111111
11111111111111111111111111111111
