11111111111111111111111111111111
11111111111111111111100000000001
10000000001111000000000000011001
10001000000110000000010001L01001
1111111000011000LD11100000L00001
1111100001100000L111100000L11001
1011000011100000L111101110L11001
1000000000001100L001101010L11001
10000110000111111111100000011111
10100000000000111000100000011011
11100000011111111111111111111111
10111100001111111111111111111111
10001000011100000000011111111111
10000000000000000000011111111111
10L00000000011100111011111111111
10L11111000001110110011111011111
10L00001000000000000011000001111
10L01101100000000000001000001111
10L11100110000000110000000001111
11111111110011100111000000000111
11000111111110000001111111111111
11110000011110000000011111111111
11110000001100000000000000000001
11100000000110000011100000000001
10000111110000000000000000000001
1000001110000000000L000000000001
1010000000001111111L000000000001
1010E00110001000111L000000000001
1111101100011000110L000000000001
11111000010100000000111110011111
11111111111111111111111111111111
11111111111111111111111111111111
