11111111111111111111111111111111
11111111111111111111111111111111
10000000L00100000000011111111111
11011111L01000000000011111111111
11000000L01011100111011111111111
11001110L00001110110011111011111
11000000L01000000000011000001111
10000000L11000000000001000001111
1000000D011000000110000000001111
11111111000011100111000000000111
11111111111110000001111111111111
11111111111100000000111111111111
10000000000000000000000000000001
11110111111000100000000000000001
11010111111000000000000000000001
10000000111011100001100000000001
10000000011011000001100000000001
10000000000000000000000000000001
10110000000000011000000000000001
11100000011000000010011110011111
11111100011111111111111111111111
11100000000111111111111100000111
11000000000000000000011100000011
1110000011100L000000011000000001
1000000000011L110000100001111101
100000000L011L110000100000111001
101111111L011L110000001000000001
101000111L011L1100000010E0011001
111000110L001L110110011110110001
1100000000100L000110011110000101
11111111111111111111111111111111
11111111111111111111111111111111
