11111111111111111111111111111111
11111111111111011111011111111111
10000000000111000100000000000011
10000000000000000000000010000001
10000000000000000000011111100001
10000000000000000000011110000111
10000000000000000000001100001111
10000000000000011001000000000001
1000000000000001D001000001100001
11111001111011111111001000000001
11111111111111111111111000000111
11111111111111000011110000000011
10000000000110000001000000000001
10111001110010000000000010000001
1011111100000L0000L0000000000001
1011111000000L1111L0001110000111
1001000000000L0000L0001100000111
1010000000000L1111L0100000000001
1010110000000L1111L0100001100001
1000100000110L1110L0000000001001
11111000001111111111111111111111
10111100001111111111100110011101
10001000011000000000100000001001
10000000000000100000011111101111
10L00000000111111000101000000001
10L11111000111100001100000111111
10L00001000011000011100000000001
10L01101100000001000000001000001
10L11100110000001000000011000001
1111111111001111110000011111E011
11000111111111111111111111111111
11111111111111111111111111111111
