11111111111111111111111111111111
11111111111111111111111111111111
10000000000111000000000000000001
10111001110110000000000000000001
1011111100011000LD11100000000001
1011111000000000L111100000000001
1001000000000000L111100000000001
1010000000001100L001100000000001
10101100000111111111100000000001
10001000001000111000111110011111
11111000001111111111111111111111
11000000001111111111111111111111
10000000001000000000000000000001
1001111100000L000000011101111111
1000000L00011L110000110101111111
1000000L11111L110000100000001111
1110000L11111L110000000000000111
1111000L00011L110000000000000001
1000000100001L110110001100000001
1011101110000L000110011000000111
11111111111111111111111111000111
10000001111111111111100000000001
10111100111000000000100000000001
10000000000000100000000000000001
10001111100111111000100100111101
10000000000111100001100100111101
11110000100011000011100100111101
1111100110000000100000E110111101
10010011100000001000011100000001
10000000000011111100011111111101
11111111111111111111111111111111
11111111111111111111111111111111
