11111111111111111111111111111111
11111111111111000011111111111111
10000000001110000001011100000001
10001000000010000000011000000001
1111111000000L0000L0011000LD1111
1111100001100L1111L0000000L11111
1011000011100L0000L0000000L11111
1000000000000L1111L0101100L00111
1000011000000L1111L0111111111111
1010000000010L1110L0000011100011
11100000011111111111111111111111
11100000000000000111111111111111
1100000000001111001110L010000001
1110000011100000000001L110000001
1000000000000011111001L000000001
100000000L000000000000L000000001
101111111L011100001000L000000001
101000111L011110011000L000010001
111000110L0001001110011100011111
11000000001000000000010000000011
11111111111111111111111100000111
11110000111000000111111000000001
10000000L00001100011110000000001
11011111L01000000000L11000001111
11000000L01000000011L00000000001
11001110L00011110011L00000000L01
11000000L01000000011L01111111L01
10000000L11000000011L01000111L01
100E0000011000011111L11000110L01
11111111000111000000L10000000011
11111111111111111111111111111111
11111111111111111111111111111111
