11111111111111111111111111111111
11111111111111111111111111111111
10000000000L00000000000011100001
11110111111L11111110000000001101
11010111111L00000000000000011111
10000000111L00000110000000000001
10000000011L00000111000000000001
10000000000L00010000000001100101
10110000000L11010000000001D00101
11100000011111111000011111111111
11111100011111111111111111111111
11000000001111111111111111111111
10000000001000000000100000000001
10011111000000100000011101111111
1000000L000111111000110101111111
1000000L111111100001100000001111
1110000L111011000011100000000111
1111000L000000001000000000000001
10000001000000001000001100000001
10111011100011111100011000000111
11111111111111111111111111000111
11110000111111000011111100001111
1110000001011000000100000000L001
1010000000001000000001011111L011
100L0000L0000L0000L001000000L011
100L1111L0000L1111L001001110L001
100L0000L0000L0000L001000000L011
100L1111L0100L1111L010000000L111
100L1111L0100L1111L0100E00000111
110L1110L0010L1110L0011111110001
11111111111111111111111111111111
11111111111111111111111111111111
