11111111111111111111111111111111
11111111111111111111111111111111
100000000000L0100000000011100001
100000000001L1100000000000001101
100000000001L0000000000000011111
100000000000L0000000000000000001
100000000000L0000000000000000001
100000000000L0000100000001100101
10000000000111000111100001D00101
11111001111100000000111111111111
11111111111111000001111111111111
11111111111100000000111111111111
10000000001000000000011111111111
10001000000000100000011111111111
11111110000000000000011111111111
11111000011011100001111111011111
10110000111011000001111000001111
10000000000000000000001000001111
10000110000000011000000000001111
10100000000000000010000000000111
11100000011111111111111111111111
11110000011000000111111111111111
100110000100111100111L0000000001
100011000000000000000L1111111001
101000011100001111100L0000000001
101111111100000000000L0000011001
100110000001110000100L0000011101
100000000001111001100L0001000001
100011001000010011100L1101000001
100011E1100000000000011111100001
11111111111111111111111111111111
11111111111111111111111111111111
