11111111111111111111111111111111
11111111111000000111111111111111
11110000000001100011100000000001
11100000000000000000L01110011101
111000LD111000000011L01111110001
100000L1111011110011L01111100001
100000L1111000000011L00100000001
101100L0011000000011L01000000001
11111111111000011111L01011000001
10001110001111000000L00010000011
11111111111111111111111110000011
11111111111111111111110000000011
10000000000000000000101100000011
10111001110000100000001100L00001
10111111000111111000101111L00001
10111110000111100001100000L00011
10010000000011000011100111L00011
10100000000000001000000000L00001
10101100000000001000000000L11101
10001000001011111100000000L10001
11111000001111111111111111111111
11110000011111111111100000011111
11110000001L00000000000110001111
11100000000L111111100000000000L1
10000111110L000000000000000011L1
10000011100L000001100011110011L1
10100000000L000001110000000011L1
1010E001100L000100000000000011L1
11111011000L110100000000011111L1
111110000101111110000111000000L1
11111111111111111111111111111111
11111111111111111111111111111111
