11111111111111111111111111111111
11111111111111111111111111111111
10000000000000111000010000000001
10000000000000000011000000000001
10000000000000000111101110011101
10000000000000000000000111011001
10000000000000000000000000000001
10000000000000011001000000000001
1000000000000001D001000000011001
11111001111111111111101110011101
11111111111111111111111000000111
11111111111000000111111000000001
10000000001001100011110000000001
10001000000000000000L11000001111
11111110000000000011L00000000001
11111000011011110011L00000000L01
10110000111000000011L01111111L01
10000000000000000011L01000111L01
10000110000000011111L11000110L01
10100000000111000000L10000000011
11100000011111111111111111111111
11000000001000000000011111111111
10000000001000000000011111111111
10011111000000000000011111111111
1000000L000001001111011111111111
1000000L111001001111011111011111
1110000L111001001111011000001111
1111000L0000E1101111001000001111
10000001000111000000000000001111
10111011100111111111000000000111
11111111111111111111111111111111
11111111111111111111111111111111
