11111111111111111111111111111111
11111111111111000011111111111111
10001110000110000001000000000001
10000000110010000000011101111111
1000000111100L0000L0010101111111
1000000000000L1111L0000000001111
1000000000000L0000L0000000000111
1000011001000L1111L0100000000001
100001D001000L1111L0101100000001
1111111111110L1110L0011000000111
11111111111111111111111111000111
11111111111111111111101111000011
11111111111000000000000010000111
11111111111111011111100000000001
1111111111110101111110L000000001
1111101111100000001110L111110001
1111000001100000000110L000010001
1111000001000000000000L011011001
1111000000001100000000L111001101
11100000000110000001111111111101
11111111111111110001110001111111
11111111111111000011111100001111
100000000000000000L0011000000101
100000000001011111L0101000000001
100000000001000000L0100L0000L001
100000000001001110L0000L1111L001
100000000001000000L0100L0000L001
100000000000000000L1100L1111L011
1000000000000E000001100L1111L011
11111001111111111100010L1110L001
11111111111111111111111111111111
11111111111111111111111111111111
