11111111111111111111111111111111
11111111111111000011111111111111
10000000000110000001000011100001
10111001110010000000000000001101
1011111100000L0000L0000000011111
1011111000000L1111L0000000000001
1001000000000L0000L0000000000001
1010000000000L1111L0100001100101
1010110000000L1111L0100001D00101
1000100000110L1110L0011111111111
11111000001111111111111111111111
11000000001111000011111111111111
10110000001110000001000000000001
101100L0000010000000011101111111
101111L000000L0000L0010101111111
100000L000100L1111L0000000001111
100111L000100L0000L0000000000111
100000L000000L1111L0100000000001
100000L111000L1111L0101100000001
100000L100010L1110L0011000000111
11111111111111111111111111000111
11111111111000000001101111000011
1L000000000011111110100010000111
1L111111100000100000000000000001
1L00000000000000000000L000000001
1L00000110000000000000L111110001
1L00000111001100111000L000010001
1L00010000000000000000L011011001
1L11010000000011011000L111001101
1111111000000010E110011111111101
11111111111111111111110001111111
11111111111111111111111111111111
