11111111111111111111111111111111
11111111111111000011111111111111
1000000000011000000100000000L001
1011100111001000000001011111L011
1011111100000L0000L001000000L011
1011111000000L1111L001001110L001
1001000000000L0000L001000000L011
1010000000000L1111L010000000L111
1010110000000L1111L01000000D0111
1000100000110L1110L0011111110001
11111000001111111111111111111111
11000000001000000111111111111111
10110000001011110011100000000011
101100L0000000000000000010000001
101111L0000000111110011111100001
100000L0001000000000011110000111
100111L0001111000010001100001111
100000L0000111100110000000000001
100000L1110001001110000001100001
100000L1000000000000001000000001
11111111111111111111111000000111
11111111111111111111111100000111
10000000000L00000000000110000101
100L0000000L11111110000011000001
111L1100001L00000000001000011101
111L1100001L00000110001111111101
111L1100000L00000111000110000001
111L1100000L00010000000000000001
101L1101100L11010000000011001001
100L0001100111111000000011E11001
11111111111111111111111111111111
11111111111111111111111111111111
