11111111111111111111111111111111
11111111111000000111111100000001
10000000000001100011111100100001
10111001110000000000L10001111001
10111111000000000011L10000000001
10111110000011110011L10000010111
10010000000000000011L00000L10D11
10100000000000000011L11111L11111
10101100000000011111L00011L11111
10001000001111000000L00000L00111
11111000001111111111111111111111
11100000000000000111111111111111
11000000000001100011100000000001
11100000111000000000L01110011101
10000000000000000011L01111110001
100000000L0011110011L01111100001
101111111L0000000011L00100000001
101000111L0000000011L01000000001
111000110L0000011111L01011000001
11000000001111000000L00010000011
11111111111111111111111110000011
11111111111111111111111100000111
1L000000000L00000000000110000101
1L111111100L11111110000011000001
1L000000000L00000000001000011101
1L000001100L00000110001111111101
1L000001110L00000111000110000001
1L000100000L00010000000000000001
1L110100000L11010000000011001001
11111110000111111000000011E11001
11111111111111111111111111111111
11111111111111111111111111111111
