11111111111111111111111111111111
11111111111111111111111111111111
100000000000000000L0000000000011
100000000001011111L0100010000001
100000000001000000L0111111100001
100000000001001110L0011110000111
100000000001000000L0101100001111
100000000000000000L1100000000001
10000000000000000D01100001100001
11111001111111111100001000000001
11111111111111111111111000000111
11111111111111000011110000000011
10000000001110000001000000000011
10001000000010000000000111110001
1111111000000L0000L00000000L0001
1111100001100L1111L00000000L1111
1011000011100L0000L00110000L1111
1000000000000L1111L01111000L0001
1000011000000L1111L0100000010001
1010000000010L1110L0001110111001
11100000011111111111111111111111
11110000011000000111111100001111
11110000001001100011111000000101
11100000000000000000L01000000001
10000111110000000011L00L0000L001
10000011100011110011L00L1111L001
10100000000000000011L00L0000L001
1010E001100000000011L00L1111L011
11111011000000011111L00L1111L011
11111000010111000000L10L1110L001
11111111111111111111111111111111
11111111111111111111111111111111
