11111111111111111111111111111111
11111111111111011111011111111111
10000000000111000100011111111111
11110111111000000000011111111111
11010111111000000000011111111111
10000000111000000000011111011111
10000000011000000000011000001111
10000000000000011001001000001111
1011000000000001D001000000001111
11100000011011111111000000000111
11111100011111111111111111111111
10000000000111111111111111111111
1000000000000000000010L010000001
1000000000000010000001L110000001
1110000000011111100011L000000001
111L000000011110000110L000000001
111L111111001100001110L000000001
100L000001000000100000L000010001
110L1111001000001000011100011111
110L0000001011111100010000000011
11111111111111111111111100000111
11111111111111111111111100000111
10000000000000000000100110000101
10000000000000100000000011000001
10000000000111111000101000011101
10000000000111100001101111111101
10000000000011000011100110000001
10000000000000001000000000000001
10000000000000001000000011001001
11111001111011111100000011E11001
11111111111111111111111111111111
11111111111111111111111111111111
