11111111111111111111111111111111
11111111111111111111111111111111
10L0100000000000000000000000L001
11L1100000000L00000001011111L011
11L0000000011L11000011000000L011
10L0000000011L11000011001110L001
10L0000000011L11000001000000L011
10L0000100011L11000000000000L111
1111000111101L1101100000000D0111
1100000000100L000110011111110001
11110000011111111111111111111111
11100000000111000011111111111111
11000000000110000001000000000011
11100000111010000000000010000001
1000000000000L0000L0011111100001
100000000L000L1111L0011110000111
101111111L000L0000L0001100001111
101000111L000L1111L0100000000001
111000110L000L1111L0100001100001
1100000000110L1110L0001000000001
11111111111111111111111000000111
11111111111000000000001111000011
10000000000000000000000010000111
100L0000000000000000000000000001
111L110000100100111100L000000001
111L110000100100111100L111110001
111L110000000100111100L000010001
111L11000000E110111100L011011001
101L110110011100000000L111001101
100L0001100111111111011111111101
11111111111111111111110001111111
11111111111111111111111111111111
