11111111111111111111111111111111
11111111111000000111111111111111
110000000L0011110011110000000001
100000001L1000000000000000000001
10001D001L0000111110001110011101
100111111L0000000000000111011001
100111111L0111000010000000000001
101111111L0111100110000000000001
111111100L0001001110000000011001
11111110000000000000001110011101
11111111111111111111111000000111
11111111111111111111101111000011
11000000000000000000000010000111
1000000000000L000000000000000001
1011100111011L11000010L000000001
1001110110011L11000010L111110001
1000000000011L11000000L000010001
1000000000011L11000000L011011001
1000000110001L11011000L111001101
1011100111000L000110011111111101
11100000011111111111110001111111
11110000011111000011111111111111
111100000011100000010L0000000001
111000000000100000000L1111111001
1000011111000L0000L00L0000000001
1000001110000L1111L00L0000011001
1010000000000L0000L00L0000011101
1010E00110000L1111L01L0001000001
1111101100000L1111L01L1101000001
1111100001010L1110L0011111100001
11111111111111111111111111111111
11111111111111111111111111111111
