11111111111111111111111111111111
11111111111111011111011111111111
10000000000111000100000000000011
10000000000000000000000010000001
10000000000000000000011111100001
10000000000000000000011110000111
10000000000000000000001100001111
10000000000000011001000000000001
1000000000000001D001000001100001
11111001111011111111001000000001
11111111111111111111111000000111
11111111111111111111100000000001
11000000000L00000000000000000001
10000000000L11111110000000000001
10111001110L00000000011000000001
10011101100L00000110011L00000001
10000000000L00000111011L11111101
10000000000L00010000000L00000101
10000001100L11010000010L11110011
10111001110111111000010L00000011
11100000011111111111111111111111
10000000000111000011111111111111
100000000001100000010L0000000001
100000000000100000000L1111111001
1001001111000L0000L00L0000000001
1001001111000L1111L00L0000011001
1001001111000L0000L00L0000011101
10E1101111000L1111L01L0001000001
1111000000000L1111L01L1101000001
1111111111010L1110L0011111100001
11111111111111111111111111111111
11111111111111111111111111111111
