11111111111111111111111111111111
11111111111111111111111111111111
100000000000000000L000L010000001
100000000001011111L011L110000001
100000000001000000L011L000000001
100000000001001110L000L000000001
100000000001000000L010L000000001
100000000000000000L110L000010001
10000000000000000D01111100011111
11111001111111111100010000000011
11111111111111111111111100000111
11111111111111000011111000000001
10000000000110000001010000000001
10111001110010000000011000001111
1011111100000L0000L0000000000001
1011111000000L1111L0000000000L01
1001000000000L0000L0001111111L01
1010000000000L1111L0101000111L01
1010110000000L1111L0111000110L01
1000100000110L1110L0010000000011
11111000001111111111111111111111
11110000011111000011111111111111
11110000001110000001000000000001
11100000000010000000000L00000001
1000011111000L0000L0011L11000011
1000001110000L1111L0011L11000011
1010000000000L0000L0011L11000001
1010E00110000L1111L0111L11000001
1111101100000L1111L0101L11011001
1111100001010L1110L0000L00011001
11111111111111111111111111111111
11111111111111111111111111111111
