11111111111111111111111111111111
11111111111000000111111101111101
10L01000000001100011111100010001
11L11000000000000000L00000000001
11L00000000000000011L00000000001
10L00000000011110011L00000000001
10L00000000000000011L00000000001
10L00001000000000011L00001100101
11110001111000011111L00001D00101
11000000001111000000L01111111101
11110000011111111111111111111111
11000000001000000111111111111111
10110000001001100011100000000001
101100L0000000000000L11101111111
101111L0000000000011L10101111111
100000L0001011110011L00000001111
100111L0001000000011L00000000111
100000L0000000000011L00000000001
100000L1110000011111L01100000001
100000L1000111000000L11000000111
11111111111111111111111111000111
11110000011000000111100000000001
10011000010011110011100000000001
10001100000000000000000000000001
10100001110000111110011000000001
10111111110000000000011L00000001
10011000000111000010011L11111101
10000000000111100110000L00000101
10001100100001001110010L11110011
100011E1100000000000010L00000011
11111111111111111111111111111111
11111111111111111111111111111111
