11111111111111111111111111111111
11111111111111111111111111111111
1000000000000011100000L010000001
1000000000000000001101L110000001
1000000000000000011111L000000001
1000000000000000000000L000000001
1000000000000000000000L000000001
1000000000000001100100L000010001
1000000000000001D001011100011111
11111001111111111111110000000011
11111111111111111111111100000111
11111111111111111111100000000001
10000000001000000000100000000001
10001000000000100000000000000001
11111110000111111000111000000001
11111000011111100001111L00000001
10110000111011000011111L11111101
10000000000000001000000L00000101
10000110000000001000010L11110011
10100000000011111100010L00000011
11100000011111111111111111111111
11000000001111000001111111111111
10110000001111000000111111111111
101100L0000110000000011111111111
101111L0000000011111011111111111
100000L0001000001110011111011111
100111L0001010000000011000001111
100000L0000010E00110001000001111
100000L1110111101100000000001111
100000L1000111100001000000000111
11111111111111111111111111111111
11111111111111111111111111111111
