11111111111111111111111111111111
11111111111111111111111111111111
10000000000000000000000011100001
10000000000111011111100000001101
10000000000101011111100000011111
10000000000000000011100000000001
10000000000000000001100000000001
10000000000000000000000001100101
10000000000011000000000001D00101
11111001111110000001111111111111
11111111111111110001111111111111
11111111111100000000111111111111
11000000000000000000111111111111
10000000000001111100011111111111
10111001110000000L00011111111111
10011101100000000L11111111011111
10000000000110000L11111000001111
10000000000111000L00001000001111
10000001100000000100000000001111
10111001110011101110000000000111
11100000011111111111111111111111
11110000011111111111111111111111
11110000001000000000100000000001
11100000000000100000000L00000001
10000111110111111000111L11000011
10000011100111100001111L11000011
10100000000011000011111L11000001
1010E001100000001000011L11000001
11111011000000001000001L11011001
11111000010011111100000L00011001
11111111111111111111111111111111
11111111111111111111111111111111
