11111111111111111111111111111111
11111111111111000000011111111111
10000000000111001000000000000001
10000000000100011110011101111111
10000000000100000000010101111111
10000000000100000101100000001111
1000000000000000L10D100000000111
1000000000011111L111100000000001
1000000000000011L111101100000001
1111100111100000L001111000000111
11111111111111111111111111000111
11111111111111111111110000000011
10L01000000000000000000000000011
11L1100000000L000000000111110001
11L0000000011L1100001000000L0001
10L0000000011L1100001000000L1111
10L0000000011L1100000110000L1111
10L0000100011L1100000111000L0001
1111000111101L110110000000010001
1100000000100L000110001110111001
11110000011111111111111111111111
10000000011111111111100000011111
10111111101000000000101111001111
10001000000000100000000000000001
10000000000111111000100011111001
10000000000111100001100000000001
10110011100011000011111100001001
10000000000000001000011110011001
10001101100000001000000100111001
100010E1100011111100000000000001
11111111111111111111111111111111
11111111111111111111111111111111
