11111111111111111111111111111111
11111111111111111111111111111111
10000000000L00000000000011100001
11110111111L11111110000000001101
11010111111L00000000000000011111
10000000111L00000110000000000001
10000000011L00000111000000000001
10000000000L00010000000001100101
10110000000L11010000000001D00101
11100000011111111000011111111111
11111100011111111111111111111111
11000000001111111111111111111111
10110000001L00000000000000000001
101100L0000L11111110001110011101
101111L0000L00000000001111110001
100000L0001L00000110001111100001
100111L0001L00000111000100000001
100000L0000L00010000001000000001
100000L1110L11010000001011000001
100000L1000111111000000010000011
11111111111111111111111110000011
11111111111000000000000000000001
10000000000000000000000000000001
10000000000000000000000000000001
10000000000001001111011000000001
10000000000001001111011L00000001
10000000000001001111011L11111101
100000000000E1101111000L00000101
10000000000111000000010L11110011
11111001111111111111010L00000011
11111111111111111111111111111111
11111111111111111111111111111111
