11111111111111111111111111111111
11111111111111000011111111111111
10001110000110000001010000000001
10000000110010000000000000000001
1000000111100L0000L0001110011101
1000000000000L1111L0000111011001
1000000000000L0000L0000000000001
1000011001000L1111L0100000000001
100001D001000L1111L0100000011001
1111111111110L1110L0001110011101
11111111111111111111111000000111
11111111111111111111111000000001
10000000000L00000000010000000001
11110111111L11111110011000001111
11010111111L00000000000000000001
10000000111L00000110000000000L01
10000000011L00000111001111111L01
10000000000L00010000001000111L01
10110000000L11010000011000110L01
11100000011111111000010000000011
11111100011111111111111111111111
11100000000000000111100000000111
11000000000001100011101111111011
11100000111000000000L00010000001
10000000000000000011L00000000001
100000000L0011110011L00000000001
101111111L0000000011L01100111001
101000111L0000000011L00000000001
111000110L0000011111L00011011001
11000000001111000000L00010E11001
11111111111111111111111111111111
11111111111111111111111111111111
