11111111111111111111111111111111
11110111110111111111111111111111
11110001000000000000111111111111
10000000000000100000011111111111
10000000000111111000011111111111
10000000000111100001111111011111
10000000000011000011111000001111
10000110010000000000001000001111
100001D0010000011000000000001111
10111111110010000000000000000111
11111111111110000001111111111111
11111111111100000000111111111111
10000000000011000000100000000001
1000000000001100L000001110011101
1000000000001111L000001111110001
1000000000000000L000101111100001
1000000000000111L000100100000001
1000000000000000L000001000000001
1000000000000000L111001011000001
1111100111100000L100000010000011
11111111111111111111111110000011
11110000011000000111110000000011
10011000010011110011101100000011
10001100000000000000001100L00001
10100001110000111110001111L00001
10111111110000000000000000L00011
10011000000111000010000111L00011
10000000000111100110000000L00001
10001100100001001110000000L11101
100011E1100000000000000000L10001
11111111111111111111111111111111
11111111111111111111111111111111
