11111111111111111111111111111111
11111111111111000000011111111111
10000000000111001000000000000001
10000000000100011110011101111111
10000000000100000000010101111111
10000000000100000101100000001111
1000000000000000L10D100000000111
1000000000011111L111100000000001
1000000000000011L111101100000001
1111100111100000L001111000000111
11111111111111111111111111000111
11111111111111111111100000000001
10000000001000000000000000000001
1000100000000L000000000000000001
1111111000011L110000111000000001
1111100001111L110000111L00000001
1011000011111L110000011L11111101
1000000000011L110000000L00000101
1000011000001L110110010L11110011
1010000000000L000110010L00000011
11100000011111111111111111111111
10011001110111111111111111111111
100000001000000000000L0000000001
1111111011100L0000000L1111111001
1010000000011L1100001L0000000001
1000001111111L1100001L0000011001
1000000000011L1100000L0000011101
1000010000011L1100000L0001000001
1000110000001L1101100L1101000001
10011111E0100L000110011111100001
11111111111111111111111111111111
11111111111111111111111111111111
