11111111111111111111111111111111
11111111111111111111111111111111
10000000001000111000011111111111
10001000000000000011011111111111
11111110000000000111111111111111
11111000011000000000011111011111
10110000111000000000011000001111
10000000000000011001001000001111
1000011000000001D001000000001111
10100000000111111111100000000111
11100000011111111111111111111111
11000000001111111111111111111111
10000000000000000000000000000011
1000100000000L000000000010000001
1000000000011L110000111111100001
1011100001111L110000111110000111
1011000001111L110000001100001111
1000000000011L110000000000000001
1000011000001L110110000001100001
1000000010000L000110001000000001
11111111111111111111111000000111
11111111111111000011111100000111
10000000000110000001000110000101
10000000000010000000000011000001
1000000000000L0000L0001000011101
1000000000000L1111L0001111111101
1000000000000L0000L0000110000001
1000000000000L1111L0100000000001
1000000000000L1111L0100011001001
1111100111110L1110L0000011E11001
11111111111111111111111111111111
11111111111111111111111111111111
