11111111111111111111111111111111
11111111111111111111111111111111
10000000000111000000010000000001
10000000000110000000000000000001
1000000000011000LD11101110011101
1000000000000000L111100111011001
1000000000000000L111100000000001
1000000000001100L001100000000001
10000000000111111111100000011001
11111001111000111000101110011101
11111111111111111111111000000111
11111111111111111111110000000011
10000000001000000000000000000001
1000100000000L000000000010000001
1111111000011L110000100000000001
1111100001111L110000101110000111
1011000011111L110000001100000111
1000000000011L110000000000000001
1000011000001L110110000001100001
1010000000000L000110000000001001
11100000011111111111111111111111
10000000011111000011111100001111
10111111101110000001011000000101
10001000000010000000001000000001
1000000000000L0000L0000L0000L001
1000000000000L1111L0000L1111L001
1011001110000L0000L0000L0000L001
1000000000000L1111L0100L1111L011
1000110110000L1111L0100L1111L011
100010E110010L1110L0010L1110L001
11111111111111111111111111111111
11111111111111111111111111111111
