11111111111111111111111111111111
11111111111111111111111111111111
10000000000000000000100011100001
10000000000000100000000000001101
10000000000111111000000000011111
10000000000111100001100000000001
10000000000011000011100000000001
10000000000000000000000001100101
10000000000000011000000001D00101
11111001111010000000011111111111
11111111111110000001111111111111
11111111111011110000111111111111
10000000000000100001111111111111
10111001110000000000011111111111
101111110000L0000000011111111111
101111100000L1111100011111011111
100100000000L0000100011000001111
101000000000L0110110001000001111
101011000000L1110011000000001111
10001000001111111111000000000111
11111000001100011111111111111111
10000000011111111111111100001111
10111111101L00000000011000000101
10001000000L11111110001000000001
10000000000L00000000000L0000L001
10000000000L00000110000L1111L001
10110011100L00000111000L0000L001
10000000000L00010000000L1111L011
10001101100L11010000000L1111L011
100010E1100111111000010L1110L001
11111111111111111111111111111111
11111111111111111111111111111111
