11111111111111111111111111111111
11111111111111111111111111111111
11000011111000000000110000000L01
11000001101000100000000000001L11
1100000010111111100000001D001L01
11000000001111100001100111111L01
11000000001011000011100111111L01
10000000000000000000001111111L01
10011101001000011000011111100L01
10111111011010000000011111100001
11111111111110000001111111111111
11111111111000000000011111111111
11111111111000000000000000000001
11111111111000000000011101111111
11111111111110000000010101111111
1111101111111L000000000000001111
1111000001111L111111000000000111
1111000001000L000001000000000001
1111000000010L111100101100000001
1110000000010L000000111000000111
11111111111111111111111111000111
11111111111001100111001111000011
10000000000000000010000010000111
10000000000111111011100000000001
1000000000001000000000L000000001
1000000000000000111110L111110001
1000000000000000000000L000010001
1000000000000001000000L011011001
1000000000000011000000L111001101
111110011110011111E0111111111101
11111111111111111111110001111111
11111111111111111111111111111111
