11111111111111111111111111111111
11110111110000000111111111111111
11110001000011110011100000000001
10000000000000000000011101111111
10000000000000111110010101111111
10000000000000000000000000001111
10000000000111000010000000000111
10000110010111100110000000000001
100001D0010001001110001100000001
10111111110000000000011000000111
11111111111111111111111111000111
11111111111111111111111000000001
10000000000100000000010000000001
10000000000000000000011000001111
10000000000011100111000000000001
10000000000001110110000000000L01
10000000000000000000001111111L01
10000000000000000000001000111L01
10000000000000000110011000110L01
11111001111011100111010000000011
11111111111110000001111111111111
11110000011000000000011111111111
11110000001000000000011111111111
11100000000000000000011111111111
10000111110110000000011111111111
1000001110011L000000011111011111
1010000000011L111111011000001111
1010E00110000L000001001000001111
1111101100010L111100100000001111
1111100001010L000000100000000111
11111111111111111111111111111111
11111111111111111111111111111111
