11111111111111111111111111111111
11111111111000000111111111111111
1000000000001111001110000000L001
1111011111100000000001011111L011
1101011111100011111001000000L011
1000000011100000000001001110L001
1000000001111100001001000000L011
1000000000011110011000000000L111
101100000000010011100000000D0111
11100000011000000000011111110001
11111100011111111111111111111111
10000000000111111111111111111111
10000000000000000000000000000011
1000000000000L000000000010000001
1110000000011L110000111111100001
111L000000011L110000111110000111
111L111111011L110000001100001111
100L000001011L110000000000000001
110L111100101L110110000001100001
110L000000100L000110001000000001
11111111111111111111111000000111
11110000111111000011110000000011
10000000L00110000001000000000001
11011111L01010000000000010000001
11000000L0100L0000L0000000000001
11001110L0000L1111L0001110000111
11000000L0100L0000L0001100000111
10000000L1100L1111L0100000000001
100E000001100L1111L0100001100001
1111111100010L1110L0000000001001
11111111111111111111111111111111
11111111111111111111111111111111
