11111111111111111111111111111111
11111111111111111111111111111111
10000000000111000000000000000001
10000000000110000000011101111111
1000000000011000LD11110101111111
1000000000000000L111100000001111
1000000000000000L111100000000111
1000000000001100L001100000000001
10000000000111111111101100000001
11111001111000111000111000000111
11111111111111111111111111000111
11111111111111000011111000000001
10000000000110000001010000000001
10111001110010000000011000001111
1011111100000L0000L0000000000001
1011111000000L1111L0000000000L01
1001000000000L0000L0001111111L01
1010000000000L1111L0101000111L01
1010110000000L1111L0111000110L01
1000100000110L1110L0010000000011
11111000001111111111111111111111
11000000001000000111111100000111
10000000001011110011111100000011
10011111000000000000011000000001
1000000L000000111110000001111101
1000000L111000000000000000111001
1110000L111111000010001000000001
1111000L0001111001100010E0011001
10000001000001001110011110110001
10111011100000000000011110000101
11111111111111111111111111111111
11111111111111111111111111111111
