11111111111111111111111111111111
11111111111111111111111111111111
1111111111110000000000000000L001
1111111111100000000001011111L011
1111111111101110011101000000L011
1111101111100111011001001110L001
1111000001100000000001000000L011
1111000001000000000000000000L111
111100000000000001100000000D0111
11100000000011100111011111110001
11111111111110000001111111111111
11111111111100000000111111111111
10000000000000000000000000000011
10000000000000100000000010000001
10000000000000000000011111100001
10000000000011100001111110000111
10000000000011000001101100001111
10000000000000000000000000000001
10000000000000011000000001100001
11111001111000000010001000000001
11111111111111111111111000000111
11110000011111111111100000000001
10011000010000000000000000000001
1000110000000L000000000000000001
1010000111011L110000111000000001
1011111111011L110000111L00000001
1001100000011L110000011L11111101
1000000000011L110000000L00000101
1000110010001L110110010L11110011
100011E110000L000110010L00000011
11111111111111111111111111111111
11111111111111111111111111111111
