11111111111111111111111111111111
11111111111111111111111111111111
1000000000010000000L010000000001
1000000000000000001L100000000001
100000000000001D001L001110011101
1000000000000111111L000111011001
1000000000000111111L000000000001
1000000000001111111L000000000001
1000000000011111100L000000011001
11111001111111111000001110011101
11111111111111111111111000000111
11111111111111111111110000000011
10000000000000000000101100000011
10111001110000100000001100L00001
10111111000111111000101111L00001
10111110000111100001100000L00011
10010000000011000011100111L00011
10100000000000001000000000L00001
10101100000000001000000000L11101
10001000001011111100000000L10001
11111000001111111111111111111111
11000000001111111111111100000111
10000000001000000000111100000011
10011111000000100000011000000001
1000000L000111111000100001111101
1000000L111111100001100000111001
1110000L111011000011101000000001
1111000L0000000010000010E0011001
10000001000000001000011110110001
10111011100011111100011110000101
11111111111111111111111111111111
11111111111111111111111111111111
