11111111111111111111111111111111
11111111111111111111111111111111
11111111111000111000000000000001
11111111111000000011011101111111
11111111111000000111110101111111
11111011111000000000000000001111
11110000011000000000000000000111
11110000010000011001000000000001
1111000000000001D001001100000001
11100000000111111111111000000111
11111111111111111111111111000111
11111111111111111111111000000001
10000000000000000000110000000001
10000000000000100000011000001111
10000000000111111000000000000001
10000000000111100001100000000L01
10000000000011000011101111111L01
10000000000000000000001000111L01
10000000000000011000011000110L01
11111001111010000000010000000011
11111111111110000001111111111111
10011001110110000000011111111111
10000000100100000000010000011011
11111110111110000011110000011011
10100000000000000000011100011011
1000001111100000000L010000011111
1000000000001111111L010000001111
1000010000001000111L000000000001
1000110000011000110L000000000001
10011111E01100000000100011110011
11111111111111111111111111111111
11111111111111111111111111111111
