11111111111111111111111111111111
11111111111111000000011111111111
11000000000111001000000000000001
10000000000100011110000000000001
10111001110100000000000000000001
10011101100100000101100000000001
1000000000000000L10D100000000001
1000000000011111L111100000000001
1000000110000011L111100000000001
1011100111000000L001111110011111
11100000011111111111111111111111
11000000001111111111111111111111
10000000001L00000000000000000011
10011111000L11111110000010000001
1000000L000L00000000011111100001
1000000L111L00000110011110000111
1110000L111L00000111001100001111
1111000L000L00010000000000000001
10000001000L11010000000001100001
10111011100111111000001000000001
11111111111111111111111000000111
11110000111000000111110000000011
10000000L00001100011100000000001
11011111L01000000000L00010000001
11000000L01000000011L00000000001
11001110L00011110011L01110000111
11000000L01000000011L01100000111
10000000L11000000011L00000000001
100E0000011000011111L00001100001
11111111000111000000L00000001001
11111111111111111111111111111111
11111111111111111111111111111111
