11111111111111111111111111111111
11111111111000000111111111111111
10L01000000011110011100011100001
11L11000000000000000000000001101
11L00000000000111110000000011111
10L00000000000000000000000000001
10L00000000111000010000000000001
10L00001000111100110000001100101
11110001111001001110000001D00101
11000000001000000000011111111111
11110000011111111111111111111111
11000000001000000111111111111111
10000000001011110011110000000001
10011111000000000000000000000001
1000000L000000111110001110011101
1000000L111000000000000111011001
1110000L111111000010000000000001
1111000L000111100110000000000001
10000001000001001110000000011001
10111011100000000000001110011101
11111111111111111111111000000111
11111111111001100111011000000001
10000000000000000010010000000001
10000000000111111011111000001111
10000000000010000000000000000001
10000000000000001111100000000L01
10000000000000000000001111111L01
10000000000000010000001000111L01
10000000000000110000011000110L01
111110011110011111E0110000000011
11111111111111111111111111111111
11111111111111111111111111111111
