11111111111111111111111111111111
11111111111000000111111111111111
110000000L0001100011100000000001
100000001L1000000000L11101111111
10001D001L0000000011L10101111111
100111111L0011110011L00000001111
100111111L0000000011L00000000111
101111111L0000000011L00000000001
111111100L0000011111L01100000001
11111110000111000000L11000000111
11111111111111111111111111000111
11111111111111000011110000000011
10000000000110000001000000000001
11110111111010000000000010000001
1101011111100L0000L0000000000001
1000000011100L1111L0001110000111
1000000001100L0000L0001100000111
1000000000000L1111L0100000000001
1011000000000L1111L0100001100001
1110000001110L1110L0000000001001
11111100011111111111111111111111
11110000011111111111111100001111
10011000010000000000111000000101
10001100000000100000001000000001
10100001110111111000100L0000L001
10111111110111100001100L1111L001
10011000000011000011100L0000L001
10000000000000001000000L1111L011
10001100100000001000000L1111L011
100011E1100011111100010L1110L001
11111111111111111111111111111111
11111111111111111111111111111111
