11111111111111111111111111111111
11111111111111111111111111111111
10000000000000000000010000000L01
10000000000111011111100000001L11
1000000000010101111110001D001L01
10000000000000000011100111111L01
10000000000000000001100111111L01
10000000000000000000001111111L01
10000000000011000000011111100L01
11111001111110000001111111100001
11111111111111110001111111111111
11111111111000000000011111111111
10000000000000000000011111111111
10111001110000000000011111111111
10111111000110000000011111111111
1011111000011L000000011111011111
1001000000011L111111011000001111
1010000000000L000001001000001111
1010110000010L111100100000001111
1000100000110L000000100000000111
11111000001111111111111111111111
11000000001001100111011111111111
10000000001000000010000000000001
10011111000111111011100L00000001
1000000L000010000000011L11000011
1000000L111000001111111L11000011
1110000L111000000000011L11000001
1111000L000000010000011L11000001
10000001000000110000001L11011001
101110111000011111E0100L00011001
11111111111111111111111111111111
11111111111111111111111111111111
