11111111111111111111111111111111
11111111111111111111111111111111
111100000000L0100000011111111111
111000000001L1100000011111111111
111000LD1111L0000000011111111111
100000L11110L0000000011111011111
100000L11110L0000000011000001111
101100L00110L0000100001000001111
11111111111111000111100000001111
10001110001100000000100000000111
11111111111111000001111111111111
11111111111100000000111111111111
11000000000000000000000000000001
10000000000000100000000000000001
10111001110000000000000000000001
10011101100011100001100000000001
10000000000011000001100000000001
10000000000000000000000000000001
10000001100000011000000000000001
10111001110000000010011110011111
11100000011111111111111111111111
11000000001111111111100110011101
10000000000L00000000000000001001
10001000000L11111110011111101111
10000000000L00000000001000000001
10111000011L00000110000000111111
10110000011L00000111000000000001
10000000000L00010000000001000001
10000110000L11010000000011000001
1000000010011111100000011111E011
11111111111111111111111111111111
11111111111111111111111111111111
