11111111111111111111111111111111
11110111110000000111111111111111
11110001000011110011100000000011
10000000000000000000000010000001
10000000000000111110011111100001
10000000000000000000011110000111
10000000000111000010001100001111
10000110010111100110000000000001
100001D0010001001110000001100001
10111111110000000000001000000001
11111111111111111111111000000111
11111111111111111111111000000001
11111111111000000000010000000001
11111111111011100111011000001111
11111111111011111100000000000001
11111011111011111000000000000L01
11110000011001000000001111111L01
11110000010010000000001000111L01
11110000000010110000011000110L01
11100000000000100000110000000011
11111111111111100000111111111111
11111111111100000000111100001111
1000000000000000000010000000L001
1000000000000111110001011111L011
10000000000000000L0001000000L011
10000000000000000L1111001110L001
10000000000110000L1111000000L011
10000000000111000L0000000000L111
10000000000000000100000E00000111
11111001111011101110011111110001
11111111111111111111111111111111
11111111111111111111111111111111
