11111111111111111111111111111111
11111111111000000111111111111111
1000000000000110001110000000L001
10111001110000000000L1011111L011
10111111000000000011L1000000L011
10111110000011110011L1001110L001
10010000000000000011L1000000L011
10100000000000000011L0000000L111
10101100000000011111L000000D0111
10001000001111000000L11111110001
11111000001111111111111111111111
11000000001000000111111111111111
10110000001001100011100000000011
101100L0000000000000L00010000001
101111L0000000000011L11111100001
100000L0001011110011L11110000111
100111L0001000000011L01100001111
100000L0000000000011L00000000001
100000L1110000011111L00001100001
100000L1000111000000L01000000001
11111111111111111111111000000111
11111111111111000001110000000011
10000000001001100001000000000011
10001000000000110000000111110001
111111100010100001110000000L0001
111110000110111111110000000L1111
101100001110011000000110000L1111
100000100000000000000111000L0001
10000010000000110010000000010001
1011111100000011E110001110111001
11111111111111111111111111111111
11111111111111111111111111111111
