11111111111111111111111111111111
11111111111111111111111101111101
11111111111000000000111100010001
11111111111000100000000000000001
11111111111111111000000000000001
11111011111111100001100000000001
11110000011011000011100000000001
11110000010000000000000001100101
11110000000000011000000001D00101
11100000000010000000001111111101
11111111111110000001111111111111
11111111111100000000111111111111
10000000000011000000100000000001
1000000000001100L000001110011101
1000000000001111L000001111110001
1000000000000000L000101111100001
1000000000000111L000100100000001
1000000000000000L000001000000001
1000000000000000L111001011000001
1111100111100000L100000010000011
11111111111111111111111110000011
11111111111111000011100000000111
10000000000110000001001111111011
100L0000000010000000000010000001
111L110000100L0000L0000000000001
111L110000100L1111L0000000000001
111L110000000L0000L0001100111001
111L110000000L1111L0100000000001
101L110110000L1111L0100011011001
100L000110010L1110L0000010E11001
11111111111111111111111111111111
11111111111111111111111111111111
