11111111111111111111111111111111
11110111110111111111111111111111
11110001000000000000011111111111
10000000000011100111011111111111
10000000000011111100011111111111
10000000000011111000011111011111
10000000000001000000011000001111
10000110010010000000001000001111
100001D0010010110000000000001111
10111111110000100000100000000111
11111111111111100000111111111111
11111111111110000000011111111111
10000000000100000000010000000001
10000000000110000011100000000001
10000000000000000000001110011101
1000000000000000000L000111011001
1000000000001111111L000000000001
1000000000001000111L000000000001
1000000000011000110L000000011001
11111001111100000000101110011101
11111111111111111111111000000111
11111111111000000111111100001111
1000000000100110001110000000L001
10001000000000000000L1011111L011
11111110001000000011L1000000L011
11111000011011110011L1001110L001
10110000111000000011L1000000L011
10000010000000000011L0000000L111
10000010000000011111L00E00000111
10111111000111000000L11111110001
11111111111111111111111111111111
11111111111111111111111111111111
