11111111111111111111111111111111
11110000000111000011111111111111
11110010000110000001000000000011
11000111100010000000000010000001
1100000000000L0000L0011111100001
1100000101100L1111L0011110000111
100000L10D100L0000L0001100001111
111111L111100L1111L0100000000001
100011L111100L1111L0100001100001
100000L001110L1110L0001000000001
11111111111111111111111000000111
11111111111000000111110000000011
10000000000011110011100000000001
10111001110000000000000010000001
10111111000000111110000000000001
10111110000000000000001110000111
10010000000111000010001100000111
10100000000111100110000000000001
10101100000001001110000001100001
10001000001000000000000000001001
11111000001111111111111111111111
11000000001000000111100000000001
10000000000001100011100000000001
10001000000000000000L00000000001
10000000000000000011L00100111101
10111000011011110011L00100111101
10110000011000000011L00100111101
10000000000000000011L0E110111101
10000110000000011111L11100000001
10000000100111000000L11111111101
11111111111111111111111111111111
11111111111111111111111111111111
