11111111111111111111111111111111
11111111111111111111111111111111
1000000000011100000000L010000001
1000000000011000000001L110000001
1000000000011000LD1111L000000001
1000000000000000L11110L000000001
1000000000000000L11110L000000001
1000000000001100L00110L000010001
10000000000111111111111100011111
11111001111000111000110000000011
11111111111111111111111100000111
11111111111111111111111000000001
10000000000000000000010000000001
1111011111100L000000011000001111
1101011111111L110000100000000001
1000000011111L110000100000000L01
1000000001111L110000001111111L01
1000000000011L110000001000111L01
1011000000001L110110011000110L01
1110000001100L000110010000000011
11111100011111111111111111111111
10011001110000000111111111111111
10000000100011110011111111111111
11111110111000000000011111111111
10100000000000111110011111111111
10000011111000000000011111011111
10000000000111000010011000001111
10000100000111100110001000001111
10001100000001001110000000001111
10011111E01000000000000000000111
11111111111111111111111111111111
11111111111111111111111111111111
