11111111111111111111111111111111
11111111111111111111111111111111
11110000000000000000111111111111
11100000000000100000011111111111
111000LD111111111000011111111111
100000L1111111100001111111011111
100000L1111011000011111000001111
101100L0011000000000001000001111
11111111111000011000000000001111
10001110001010000000000000000111
11111111111110000001111111111111
11111111111100000000111111111111
10000000000000000000100000000011
10000000000001111100000010000001
10000000000000000L00011111100001
10000000000000000L11111110000111
10000000000110000L11101100001111
10000000000111000L00000000000001
10000000000000000100000001100001
11111001111011101110001000000001
11111111111111111111111000000111
11111111111111111111100000000111
10000000001000000000101111111011
10001000000000100000000010000001
11111110001111111000100000000001
11111000011111100001100000000001
10110000111011000011101100111001
10000010000000001000000000000001
10000010000000001000000011011001
10111111000011111100000010E11001
11111111111111111111111111111111
11111111111111111111111111111111
