11111111111111111111111111111111
11111111111111111111111111111111
100000000000L010000000000000L001
111000000111L110000001011111L011
111101010111L000000001000000L011
111111111110L000000001001110L001
111010100110L000000001000000L011
100000000100L000010000000000L111
100010000111110001111000000D0111
10011111000100000000111111110001
11111111111111000001111111111111
11111111111110000000011111111111
11111111111100000000000000000011
11111111111110000011100010000001
11111111111000000000011111100001
1111101111100000000L011110000111
1111000001101111111L001100001111
1111000001001000111L000000000001
1111000000011000110L000001100001
11100000000100000000101000000001
11111111111111111111111000000111
11111111111111111111111100000111
10000000000L00000000000110000101
10000000000L11111110000011000001
10000000000L00000000001000011101
10000000000L00000110001111111101
10000000000L00000111000110000001
10000000000L00010000000000000001
10000000000L11010000000011001001
11111001111111111000000011E11001
11111111111111111111111111111111
11111111111111111111111111111111
