11111111111111111111111111111111
11111111111111000011111111111111
10000000L00110000001000000000011
11011111L01010000000000010000001
11000000L0100L0000L0011111100001
11001110L0000L1111L0011110000111
11000000L0100L0000L0001100001111
10000000L1100L1111L0100000000001
1000000D01100L1111L0100001100001
1111111100010L1110L0001000000001
11111111111111111111111000000111
11111111111111111111100000000001
10000000000100000000000000000001
10000000000000000000000000000001
10000000000011100111011000000001
10000000000001110110011L00000001
10000000000000000000011L11111101
10000000000000000000000L00000101
10000000000000000110010L11110011
11111001111011100111010L00000011
11111111111110000001111111111111
10000001111000000000011111111111
10011000111000000000011111111111
1000000000L000000000011111111111
1000000011L001001111011111111111
1011110011L001001111011111011111
1000000011L001001111011000001111
1000000011L0E1101111001000001111
1000011111L111000000000000001111
1111000000L111111111000000000111
11111111111111111111111111111111
11111111111111111111111111111111
