11111111111111111111111111111111
11111111111111011111011111111111
10L01000000111000100011111111111
11L11000000000000000011111111111
11L00000000000000000011111111111
10L00000000000000000011111011111
10L00000000000000000011000001111
10L00001000000011001001000001111
1111000111100001D001000000001111
11000000001011111111000000000111
11110000011111111111111111111111
11000000001111111111111111111111
10110000001000000000000000000001
101100L000000L000000011101111111
101111L000011L110000110101111111
100000L000111L110000100000001111
100111L000111L110000000000000111
100000L000011L110000000000000001
100000L111001L110110001100000001
100000L100000L000110011000000111
11111111111111111111111111000111
11111111111111000011100000000001
100000000000000000L0000000000001
100000000001011111L0100000000001
100000000001000000L0111000000001
100000000001001110L0011L00000001
100000000001000000L0111L11111101
100000000000000000L1100L00000101
1000000000000E000001110L11110011
11111001111111111100010L00000011
11111111111111111111111111111111
11111111111111111111111111111111
