11111111111111111111111111111111
11110111110111111111111111111111
11110001000L0000000000L010000001
10000000000L1111111001L110000001
10000000000L0000000001L000000001
10000000000L0000011000L000000001
10000000000L0000011100L000000001
10000110010L0001000000L000010001
100001D0010L11010000011100011111
10111111110111111000010000000011
11111111111111111111111100000111
11111111111000000111110000000011
10L01000000011110011100000000011
11L11000000000000000000111110001
11L000000000001111100000000L0001
10L000000000000000000000000L1111
10L000000001110000100110000L1111
10L000010001111001100111000L0001
11110001111001001110000000010001
11000000001000000000001110111001
11110000011111111111111111111111
11110000011000000111100000011111
11110000001011110011100110001111
111000000000000000000000000000L1
100001111100001111100000000011L1
100000111000000000000011110011L1
101000000001110000100000000011L1
1010E0011001111001100000000011L1
111110110000010011100000011111L1
111110000100000000000111000000L1
11111111111111111111111111111111
11111111111111111111111111111111
