11111111111111111111111111111111
11111111111111111111111111111111
1000000000010000000L010000000001
1000000000000000001L100000000001
100000000000001D001L001110011101
1000000000000111111L000111011001
1000000000000111111L000000000001
1000000000001111111L000000000001
1000000000011111100L000000011001
11111001111111111000001110011101
11111111111111111111111000000111
11111111111111111111110000000011
10000000001000000000100000000011
10001000000000100000000111110001
111111100001111110001000000L0001
111110000111111000011000000L1111
101100001110110000111110000L1111
100000000000000010000111000L0001
10000110000000001000000000010001
10100000000011111100001110111001
11100000011111111111111111111111
11000000001000000000011111111111
10000000001000000000011111111111
10011111000000000000011111111111
1000000L000001001111011111111111
1000000L111001001111011111011111
1110000L111001001111011000001111
1111000L0000E1101111001000001111
10000001000111000000000000001111
10111011100111111111000000000111
11111111111111111111111111111111
11111111111111111111111111111111
