11111111111111111111111111111111
11111111111111011111011111111111
1000000000011100010000L010000001
1110000001100000000001L110000001
1111010101100000000001L000000001
1111111111100000000000L000000001
1110101001100000000000L000000001
1000000001000001100100L000010001
1000100001100001D001011100011111
10011111000011111111010000000011
11111111111111111111111100000111
11111111111111111111110000000011
11111111111100000000000000000001
11111111111000000000000010000001
11111111111011100111000000000001
11111011111001110110001110000111
11110000011000000000001100000111
11110000010000000000000000000001
11110000000000000110000001100001
11100000000011100111000000001001
11111111111110000001111111111111
11111111111111000001111111111111
10000000000111000000100000000011
10000000000110000000000010000001
10000000000000011111011111100011
10000000000000001110011110000111
10000000000010000000001100001111
10000000000010E00110000000100001
10000000000111101100000000100001
11111001111111100001001111110001
11111111111111111111111111111111
11111111111111111111111111111111
