11111111111111111111111111111111
11111111111111111111111111111111
10000000000111000000010000000001
10000000000110000000000000000001
1000000000011000LD11101110011101
1000000000000000L111100111011001
1000000000000000L111100000000001
1000000000001100L001100000000001
10000000000111111111100000011001
11111001111000111000101110011101
11111111111111111111111000000111
11111111111111000011110000000011
10000000000110000001001100000011
10111001110010000000001100L00001
1011111100000L0000L0001111L00001
1011111000000L1111L0000000L00011
1001000000000L0000L0000111L00011
1010000000000L1111L0100000L00001
1010110000000L1111L0100000L11101
1000100000110L1110L0000000L10001
11111000001111111111111111111111
11000000001111000001111111111111
10110000001001100001000000000001
101100L0000000110000000L00000001
101111L0000010000111011L11000011
100000L0001011111111011L11000011
100111L0001001100000011L11000001
100000L0000000000000011L11000001
100000L1110000110010001L11011001
100000L100000011E110000L00011001
11111111111111111111111111111111
11111111111111111111111111111111
