11111111111111111111111111111111
11111111111111111111111111111111
1000000000010000000L010000111111
1111011111100000001L110000011011
110101111110001D001L010000001011
1000000011100111111L010000000011
1000000001100111111L010000000011
1000000000001111111L000000000001
1011000000011111100L000111010011
11100000011111111000001111110111
11111100011111111111111111111111
11100000000111111111111111111111
11000000000000000000111111111111
11100000111000100000011111111111
10000000000111111000011111111111
100000000L0111100001111111011111
101111111L0011000011111000001111
101000111L0000000000001000001111
111000110L0000011000000000001111
11000000001010000000000000000111
11111111111110000001111111111111
11111111111000000000000000011111
10000000000000000000000110001111
100000000000000000000000000000L1
100000000000010011110000000011L1
100000000000010011110011110011L1
100000000000010011110000000011L1
100000000000E11011110000000011L1
100000000001110000000000011111L1
111110011111111111110111000000L1
11111111111111111111111111111111
11111111111111111111111111111111
