11111111111111111111111111111111
11111111111111111111111111111111
1100000000000000000000000000L001
1000000000000L00000001011111L011
1011100111011L11000011000000L011
1001110110011L11000011001110L001
1000000000011L11000001000000L011
1000000000011L11000000000000L111
1000000110001L1101100000000D0111
1011100111000L000110011111110001
11100000011111111111111111111111
11000000001111111111111111111111
10000000000100000000011111111111
10001000000000000000011111111111
10000000000011100111011111111111
10111000011001110110011111011111
10110000011000000000011000001111
10000000000000000000001000001111
10000110000000000110000000001111
10000000100011100111000000000111
11111111111110000001111111111111
11111111111000000001111111111111
10000000000011111110100000000011
10000000000000100000000010000001
10000000000000000000011111100011
10000000000000000000011110000111
10000000000011001110001100001111
10000000000000000000000000100001
10000000000000110110000000100001
1111100111100010E110001111110001
11111111111111111111111111111111
11111111111111111111111111111111
