11111111111111111111111111111111
11111111111111111111111111111111
10000000000100000000000011100001
10000000000000000000000000001101
10000000000011100111000000011111
10000000000001110110000000000001
10000000000000000000000000000001
10000000000000000000000001100101
10000000000000000110000001D00101
11111001111011100111011111111111
11111111111110000001111111111111
11111111111110000000011111111111
10000000001100000000011111111111
10001000000110000011111111111111
11111110000000000000011111111111
1111100001100000000L011111011111
1011000011101111111L011000001111
1000000000001000111L001000001111
1000011000011000110L000000001111
10100000000100000000100000000111
11100000011111111111111111111111
10000000000000000111111100000111
10000000000001100011100110000101
10000000000000000000L00011000001
11100000000000000011L01000011101
111L0000000011110011L01111111101
111L1111110000000011L00110000001
100L0000010000000011L00000000001
110L1111001000011111L00011001001
110L0000001111000000L00011E11001
11111111111111111111111111111111
11111111111111111111111111111111
