11111111111111111111111111111111
11111111111111111111111111111111
10000000000000000000100011100001
10111001110000100000000000001101
10111111000111111000100000011111
10111110000111100001100000000001
10010000000011000011100000000001
10100000000000001000000001100101
10101100000000001000000001D00101
10001000001011111100011111111111
11111000001111111111111111111111
11000000001111111111111111111111
101100000010L0100000011111111111
101100L00001L1100000011111111111
101111L00001L0000000011111111111
100000L00010L0000000011111011111
100111L00010L0000000011000001111
100000L00000L0000100001000001111
100000L1110111000111100000001111
100000L1000100000000100000000111
11111111111111000001111111111111
11111111111100000000111100000111
10000000000000000000100110000101
10000000000001111100000011000001
10000000000000000L00001000011101
10000000000000000L11101111111101
10000000000110000L11100110000001
10000000000111000L00000000000001
10000000000000000100000011001001
11111001111011101110000011E11001
11111111111111111111111111111111
11111111111111111111111111111111
