11111111111111111111111111111111
11111111111111111111111111111111
10001110000100000000001001100L01
100000001100000000000010L0011L11
100000011110111001110011L1111L11
100000000000011101100111L1111L11
10000000000000000000011100011L11
10000110010000000000011011000L11
100001D0010000000110011011011L11
11111111111011100111011000011111
11111111111110000001111111111111
11111111111011110000111111111111
10000000001000100001111111111111
10001000000000000000011111111111
111111100000L0000000011111111111
111110000110L1111100011111011111
101100001110L0000100011000001111
100000000000L0110110001000001111
100001100000L1110011000000001111
10100000000111111111000000000111
11100000011100011111111111111111
10000000000000000000011111111111
10000000000000000000000000000001
10000000000000000000000000000001
11100000000001001111000000000001
111L0000000001001111000000000001
111L1111110001001111000000000001
100L00000100E1101111000000000001
110L1111001111000000000000000001
110L0000001111111111011110011111
11111111111111111111111111111111
11111111111111111111111111111111
