11111111111111111111111111111111
11111111111111011111011111111111
10000000000111000100000000000001
10000000000000000000011101111111
10000000000000000000010101111111
10000000000000000000000000001111
10000000000000000000000000000111
10000000000000011001000000000001
1000000000000001D001001100000001
11111001111011111111011000000111
11111111111111111111111111000111
11111111111111000011111000000001
10L01000000110000001010000000001
11L11000000010000000011000001111
11L0000000000L0000L0000000000001
10L0000000000L1111L0000000000L01
10L0000000000L0000L0001111111L01
10L0000100000L1111L0101000111L01
1111000111100L1111L0111000110L01
1100000000110L1110L0010000000011
11110000011111111111111111111111
11000000001000000000011111111111
101100000010000000000L0000000001
101100L00000000000000L1111111001
101111L00000010011110L0000000001
100000L00010010011110L0000011001
100111L00010010011110L0000011101
100000L00000E11011110L0001000001
100000L11101110000000L1101000001
100000L1000111111111011111100001
11111111111111111111111111111111
11111111111111111111111111111111
