11111111111111111111111111111111
11111111111111111111111111111111
10000000000000111000000000000001
10000000000000000011011101111111
10000000000000000111110101111111
10000000000000000000000000001111
10000000000000000000000000000111
10000000000000011001000000000001
1000000000000001D001001100000001
11111001111111111111111000000111
11111111111111111111111111000111
11111111111000000111110000000011
10L01000000011110011100000000011
11L11000000000000000000111110001
11L000000000001111100000000L0001
10L000000000000000000000000L1111
10L000000001110000100110000L1111
10L000010001111001100111000L0001
11110001111001001110000000010001
11000000001000000000001110111001
11110000011111111111111111111111
10011001110111111111111100001111
10000000100000000000111000000101
11111110111000100000001000000001
10100000000111111000100L0000L001
10000011111111100001100L1111L001
10000000000011000011100L0000L001
10000100000000001000000L1111L011
10001100000000001000000L1111L011
10011111E01011111100010L1110L001
11111111111111111111111111111111
11111111111111111111111111111111
