11111111111111111111111111111111
11111111111111111111111100000001
11111111111000000000111100100001
11111111111000100000010001111001
11111111111111111000010000000001
11111011111111100001110000010111
11110000011011000011100000L10D11
11110000010000000000011111L11111
11110000000000011000000011L11111
11100000000010000000000000L00111
11111111111110000001111111111111
11111111111110000000011111111111
1000000000010000000000L010000001
1000000000011000001111L110000001
1000000000000000000001L000000001
1000000000000000000L00L000000001
1000000000001111111L00L000000001
1000000000001000111L00L000010001
1000000000011000110L011100011111
11111001111100000000110000000011
11111111111111111111111100000111
10000001111111000011111100001111
1001100011111000000100000000L001
1000000000L01000000001011111L011
1000000011L00L0000L001000000L011
1011110011L00L1111L001001110L001
1000000011L00L0000L001000000L011
1000000011L00L1111L010000000L111
1000011111L00L1111L0100E00000111
1111000000L10L1110L0011111110001
11111111111111111111111111111111
11111111111111111111111111111111
