11111111111111111111111111111111
11111111111000000111111111111111
11000000000001100011110000000L01
10000000000000000000L00000001L11
10111001110000000011L0001D001L01
10011101100011110011L00111111L01
10000000000000000011L00111111L01
10000000000000000011L01111111L01
10000001100000011111L11111100L01
10111001110111000000L11111100001
11100000011111111111111111111111
11000000001111111111111111111111
100000000000L0100000011111111111
100010000001L1100000011111111111
100000000001L0000000011111111111
101110000110L0000000011111011111
101100000110L0000000011000001111
100000000000L0000100001000001111
10000110000111000111100000001111
10000000100100000000100000000111
11111111111111000001111111111111
11111111111111000001111111111111
10000000000111000000100000000001
100L0000000110000000000000000001
111L1100001000011111000000000001
111L1100001000001110000000000001
111L1100000010000000000000000001
111L1100000010E00110000000000001
101L1101100111101100000000000001
100L0001100111100001011110011111
11111111111111111111111111111111
11111111111111111111111111111111
