11111111111111111111111111111111
11111111111111111111111111111111
10000000000000000000010000000L01
1011100111000L000000000000001L11
1011111100011L11000010001D001L01
1011111000011L110000100111111L01
1001000000011L110000000111111L01
1010000000011L110000001111111L01
1010110000001L110110011111100L01
1000100000100L000110011111100001
11111000001111111111111111111111
11000000001111111111111111111111
10000000001000000000100000000001
10011111000000100000001110011101
1000000L000111111000101111110001
1000000L111111100001101111100001
1110000L111011000011100100000001
1111000L000000001000001000000001
10000001000000001000001011000001
10111011100011111100000010000011
11111111111111111111111110000011
10011001110111000011110000000011
10000000100110000001001100000011
11111110111010000000001100L00001
1010000000000L0000L0001111L00001
1000001111100L1111L0000000L00011
1000000000000L0000L0000111L00011
1000010000000L1111L0100000L00001
1000110000000L1111L0100000L11101
10011111E0110L1110L0000000L10001
11111111111111111111111111111111
11111111111111111111111111111111
