11111111111111111111111111111111
11111111111111111111111111111111
10000000L000000000L0000000000011
11011111L011011111L0100010000001
11000000L011000000L0111111100001
11001110L001001110L0011110000111
11000000L011000000L0101100001111
10000000L010000000L1100000000001
10000000111000000D01100001100001
11111111111111111100001000000001
11111111111111111111111000000111
11111111111111111111101111000011
11111111111000000000100010000111
11111111111000100000000000000001
1111111111111111100000L000000001
1111101111111110000110L111110001
1111000001101100001110L000010001
1111000001000000000000L011011001
1111000000000001100000L111001101
11100000000010000000011111111101
11111111111110000001110001111111
11111111111111000001100000011111
10000000000001100001000110001111
100000000000001100000000000000L1
100000000000100001110000000011L1
100000000000111111110011110011L1
100000000000011000000000000011L1
100000000000000000000000000011L1
100000000000001100100000011111L1
1111100111100011E1100111000000L1
11111111111111111111111111111111
11111111111111111111111111111111
