11111111111111111111111111111111
11111111111111111111111111111111
1000000000000011100000L010000001
1000000000000000001101L110000001
1000000000000000011111L000000001
1000000000000000000000L000000001
1000000000000000000000L000000001
1000000000000001100100L000010001
1000000000000001D001011100011111
11111001111111111111110000000011
11111111111111111111111100000111
11111111111111111111101111000011
10000000000000000000000010000111
1111011111100L000000000000000001
1101011111111L11000010L000000001
1000000011111L11000010L111110001
1000000001111L11000000L000010001
1000000000011L11000000L011011001
1011000000001L11011000L111001101
1110000001100L000110011111111101
11111100011111111111110001111111
10000000011111000011111111111111
10111111101110000001011111111111
10001000000010000000011111111111
1000000000000L0000L0011111111111
1000000000000L1111L0011111011111
1011001110000L0000L0011000001111
1000000000000L1111L0101000001111
1000110110000L1111L0100000001111
100010E110010L1110L0000000000111
11111111111111111111111111111111
11111111111111111111111111111111
