11111111111111111111111111111111
11111111111111111111111111111111
11110000000000000000010000000001
1110000000000L000000000000000001
111000LD11111L110000101110011101
100000L111111L110000100111011001
100000L111111L110000000000000001
101100L001111L110000000000000001
1111111111101L110110000000011001
1000111000100L000110001110011101
11111111111111111111111000000111
11111111111111111111110000000011
10000000001L00000000000000000011
10001000000L11111110000111110001
11111110000L000000000000000L0001
11111000011L000001100000000L1111
10110000111L000001110110000L1111
10000000000L000100000111000L0001
10000110000L11010000000000010001
10100000000111111000001110111001
11100000011111111111111111111111
11100000000111000001111111111111
11000000000001100001000000000001
11100000111000110000000L00000001
10000000000010000111011L11000011
100000000L0011111111011L11000011
101111111L0001100000011L11000001
101000111L0000000000011L11000001
111000110L0000110010001L11011001
1100000000100011E110000L00011001
11111111111111111111111111111111
11111111111111111111111111111111
