11111111111111111111111111111111
11111111111111111111111111111111
10000000000111000000000000000001
10000000000110000000001110011101
1000000000011000LD11101111110001
1000000000000000L111101111100001
1000000000000000L111100100000001
1000000000001100L001101000000001
10000000000111111111101011000001
11111001111000111000100010000011
11111111111111111111111110000011
11111111111000000111111000000001
10000000000001100011110000000001
11110111111000000000L11000001111
11010111111000000011L00000000001
10000000111011110011L00000000L01
10000000011000000011L01111111L01
10000000000000000011L01000111L01
10110000000000011111L11000110L01
11100000011111000000L10000000011
11111100011111111111111111111111
10111100001000000111100000000001
10001000011001100011100000000001
10000000000000000000L00000000001
10L00000000000000011L00100111101
10L11111000011110011L00100111101
10L00001000000000011L00100111101
10L01101100000000011L0E110111101
10L11100110000011111L11100000001
11111111110111000000L11111111101
11000111111111111111111111111111
11111111111111111111111111111111
