11111111111111111111111111111111
11111111111000000111111101111101
10000000000011110011111100010001
10111001110000000000000000000001
10111111000000111110000000000001
10111110000000000000000000000001
10010000000111000010000000000001
10100000000111100110000001100101
10101100000001001110000001D00101
10001000001000000000001111111101
11111000001111111111111111111111
11000000001111111111111111111111
10000000001000000000100000000011
10011111000000100000000010000001
1000000L000111111000111111100001
1000000L111111100001111110000111
1110000L111011000011101100001111
1111000L000000001000000000000001
10000001000000001000000001100001
10111011100011111100001000000001
11111111111111111111111000000111
10000000000111111111101111000011
10000000000000000000100010000111
10000000000000100000000000000001
1001001111011111100010L000000001
1001001111011110000110L111110001
1001001111001100001110L000010001
10E1101111000000100000L011011001
1111000000000000100000L111001101
11111111110011111100011111111101
11111111111111111111110001111111
11111111111111111111111111111111
