11111111111111111111111111111111
11111111111111111111111111111111
10000000L0000000000000000000L001
11011111L0101110011101011111L011
11000000L0101111110001000000L011
11001110L0001111100001001110L001
11000000L0100100000001000000L011
10000000L1101000000000000000L011
1000000D011010110000000000001111
11111111000000100000111111111111
11111111111111100000111111111111
11111111111110000000011111111111
10000000001100000000011111111111
10001000000110000011111111111111
11111110000000000000011111111111
1111100001100000000L011111011111
1011000011101111111L011000001111
1000000000001000111L001000001111
1000011000011000110L000000001111
10100000000100000000100000000111
11100000011111111111111111111111
10000000000000000001111111111111
10000000000011111110100000000001
10000000000000100000000000000001
11100000000000000000000000000001
111L0000000000000000000000000001
111L1111110011001110000000000001
100L0000010000000000000000000001
110L1111001000110110000000000001
110L000000100010E110011110011111
11111111111111111111111111111111
11111111111111111111111111111111
