11111111111111111111111111111111
11111111111111111111111101111101
100000000000L0100000011100010001
100000000001L1100000000000000001
100000000001L0000000000000000001
100000000000L0000000000000000001
100000000000L0000000000000000001
100000000000L0000100000001100101
10000000000111000111100001D00101
11111001111100000000101111111101
11111111111111000001111111111111
11111111111100000000111111111111
10000000000011000000101001100L01
1011100111001100L0000010L0011L11
1011111100001111L0000011L1111L11
1011111000000000L0001111L1111L11
1001000000000111L000111100011L11
1010000000000000L000011011000L11
1010110000000000L111011011011L11
1000100000100000L100011000011111
11111000001111111111111111111111
11100000000111000001111111111111
11000000000001100001011111111111
11100000111000110000011111111111
10000000000010000111011111111111
100000000L0011111111011111011111
101111111L0001100000011000001111
101000111L0000000000001000001111
111000110L0000110010000000001111
1100000000100011E110000000000111
11111111111111111111111111111111
11111111111111111111111111111111
