11111111111111111111111111111111
11111111111111111111111111111111
10000000001000111000000000000001
10001000000000000011000000000001
11111110000000000111100000000001
11111000011000000000000000000001
10110000111000000000000000000001
10000000000000011001000000000001
1000011000000001D001000000000001
10100000000111111111111110011111
11100000011111111111111111111111
11000000001000000111111111111111
10000000001011110011100000000011
10011111000000000000000010000001
1000000L000000111110011111100001
1000000L111000000000011110000111
1110000L111111000010001100001111
1111000L000111100110000000000001
10000001000001001110000001100001
10111011100000000000001000000001
11111111111111111111111000000111
10000001111111000001110000000011
10011000111111000000100000000011
1000000000L110000000000111110001
1000000011L0000111110000000L0001
1011110011L0000011100000000L1111
1000000011L0100000000110000L1111
1000000011L010E001100111000L0001
1000011111L111101100000000010001
1111000000L111100001001110111001
11111111111111111111111111111111
11111111111111111111111111111111
