11111111111111111111111111111111
11111111111111111111111111111111
10000000L00L00000000000000000001
11011111L01L11111110001110011101
11000000L01L00000000001111110001
11001110L00L00000110001111100001
11000000L01L00000111000100000001
10000000L11L00010000001000000001
1000000D011L11010000001011000001
11111111000111111000000010000011
11111111111111111111111110000011
11111111111111111111110000000011
10000000000000000000100000000001
11110111111000100000000010000001
11010111111111111000100000000001
10000000111111100001101110000111
10000000011011000011101100000111
10000000000000001000000000000001
10110000000000001000000001100001
11100000011011111100000000001001
11111100011111111111111111111111
11110000011111111111111111111111
10011000010L00000000000000000001
10001100000L11111110000L00000001
10100001110L00000000011L11000011
10111111110L00000110011L11000011
10011000000L00000111011L11000001
10000000000L00010000011L11000001
10001100100L11010000001L11011001
100011E1100111111000000L00011001
11111111111111111111111111111111
11111111111111111111111111111111
