11111111111111111111111111111111
10000000000111111111111111111111
100000011000000000L0000000000011
110001L01001011111L0100010000001
100000L00001000000L0111111100001
100000L11001001110L0011110000111
101110L11001000000L0101100001111
101010L11000000000L1100000000001
10000001111000000D01100001100001
10000001101111111100001000000001
11111111111111111111111000000111
11111111111111111111100000000001
11111111111100000000000000000001
11111111111000000000000000000001
11111111111011100111011000000001
11111011111001110110011L00000001
11110000011000000000011L11111101
11110000010000000000000L00000101
11110000000000000110010L11110011
11100000000011100111010L00000011
11111111111110000001111111111111
11111111111100000000111100001111
1000000000000000000010000000L001
1000000000000111110001011111L011
10000000000000000L0001000000L011
10000000000000000L1111001110L001
10000000000110000L1111000000L011
10000000000111000L0000000000L111
10000000000000000100000E00000111
11111001111011101110011111110001
11111111111111111111111111111111
11111111111111111111111111111111
