11111111111111111111111111111111
11111111111111111111111111111111
10000000L00000000000011111111111
11011111L01111011111111111111111
11000000L01101011111111111111111
11001110L00000000011111111011111
11000000L01000000001111000001111
10000000L11000000000001000001111
1000000D011011000000000000001111
11111111000110000001100000000111
11111111111111110001111111111111
11111111111011110000111111111111
10000000000000100001100000000001
10000000000000000000001110011101
100000000000L0000000001111110001
100000000000L1111100001111100001
100000000000L0000100000100000001
100000000000L0110110001000000001
100000000000L1110011001011000001
11111001111111111111000010000011
11111111111100011111111110000011
11111111111111111111100000000001
10000000001000000000000000000001
1000100000000L000000000000000001
1111111000111L110000100100111101
1111100001111L110000100100111101
1011000011111L110000000100111101
1000001000011L11000000E110111101
1000001000001L110110011100000001
1011111100000L000110011111111101
11111111111111111111111111111111
11111111111111111111111111111111
