11111111111111111111111111111111
11111111111111111111111111111111
110000000L0L00000000000000000001
100000001L1L11111110001110011101
10001D001L0L00000000001111110001
100111111L0L00000110001111100001
100111111L0L00000111000100000001
101111111L0L00010000001000000001
111111100L0L11010000001011000001
11111110000111111000000010000011
11111111111111111111111110000011
11111111111111111111110000000011
10000000000000000000100000000001
10000000000000100000000010000001
10000000000111111000000000000001
10000000000111100001101110000111
10000000000011000011101100000111
10000000000000000000000000000001
10000000000000011000000001100001
11111001111010000000000000001001
11111111111110000001111111111111
11111111111111000001111111111111
1L000000000111000000111111111111
1L111111100110000000011111111111
1L000000000000011111011111111111
1L000001100000001110011111011111
1L000001110010000000011000001111
1L000100000010E00110001000001111
1L110100000111101100000000001111
11111110000111100001000000000111
11111111111111111111111111111111
11111111111111111111111111111111
