11111111111111111111111111111111
11111111111000000111111101111101
10000000000001100011111100010001
10111001110000000000L00000000001
10111111000000000011L00000000001
10111110000011110011L00000000001
10010000000000000011L00000000001
10100000000000000011L00001100101
10101100000000011111L00001D00101
10001000001111000000L01111111101
11111000001111111111111111111111
11000000001111111111111111111111
10000000001000000000011111111111
10011111000111011111111111111111
1000000L000101011111111111111111
1000000L111000000011111111011111
1110000L111000000001111000001111
1111000L000000000000001000001111
10000001000011000000000000001111
10111011100110000001100000000111
11111111111111110001111111111111
11111111111111000011111111111111
100000000000000000L0000000000001
100L00000001011111L0100000000001
111L11000011000000L0100000000001
111L11000011001110L0000000000001
111L11000001000000L0100000000001
111L11000000000000L1100000000001
101L110110000E000001100000000001
100L0001100111111100011110011111
11111111111111111111111111111111
11111111111111111111111111111111
