11111111111111111111111111111111
11111111111111111111111111111111
10001110000000000000011111111111
10000000110111011111111111111111
10000001111101011111111111111111
10000000000000000011111111011111
10000000000000000001111000001111
10000110010000000000001000001111
100001D0010011000000000000001111
11111111111110000001100000000111
11111111111111110001111111111111
11111111111000000000011111111111
10000000000000000000000000000001
10000000000000000000001110011101
10000000000110000000001111110001
1000000000011L000000001111100001
1000000000011L111111000100000001
1000000000000L000001001000000001
1000000000010L111100101011000001
1111100111110L000000100010000011
11111111111111111111111110000011
10000001111111000001110000000011
10111100111001100001000000000011
10000000000000110000000111110001
100011111000100001110000000L0001
100000000000111111110000000L1111
111100001000011000000110000L1111
111110011000000000000111000L0001
10010011100000110010000000010001
1000000000000011E110001110111001
11111111111111111111111111111111
11111111111111111111111111111111
