11111111111111111111111111111111
11111111111111011111011111111111
11000011111111000100000000000001
11000001101000000000001110011101
11000000101000000000001111110001
11000000001000000000001111100001
11000000001000000000000100000001
10000000000000011001001000000001
1001110100100001D001001011000001
10111111011011111111000010000011
11111111111111111111111110000011
11111111111111111111100000000001
11111111111000000000000000000001
11111111111011100111000000000001
11111111111011111100011000000001
11111011111011111000011L00000001
11110000011001000000011L11111101
11110000010010000000000L00000101
11110000000010110000010L11110011
11100000000000100000110L00000011
11111111111111100000111111111111
11111111111110000000011100000111
10000000000100000000000110000101
10000000000110000011100011000001
10000000000000000000001000011101
1000000000000000000L001111111101
1000000000001111111L000110000001
1000000000001000111L000000000001
1000000000011000110L000011001001
11111001111100000000100011E11001
11111111111111111111111111111111
11111111111111111111111111111111
