11111111111111111111111111111111
11111111111111111111111111111111
10000000000111000000000000000001
10111001110110000000000000000001
1011111100011000LD11100000000001
1011111000000000L111100000000001
1001000000000000L111100000000001
1010000000001100L001100000000001
10101100000111111111100000000001
10001000001000111000111110011111
11111000001111111111111111111111
10000000000111111111111111111111
10000000000000000000000000000001
1000000000000L000000011101111111
1110000000011L110000110101111111
111L000000011L110000100000001111
111L111111011L110000000000000111
100L000001011L110000000000000001
110L111100101L110110001100000001
110L000000100L000110011000000111
11111111111111111111111111000111
11110000011111111111110000000011
10011000010L00000000000000000011
10001100000L11111110000111110001
10100001110L000000000000000L0001
10111111110L000001100000000L1111
10011000000L000001110110000L1111
10000000000L000100000111000L0001
10001100100L11010000000000010001
100011E1100111111000001110111001
11111111111111111111111111111111
11111111111111111111111111111111
