11111111111111111111111111111111
11111111111000000111111111111111
10000000000011110011100011100001
11110111111000000000000000001101
11010111111000111110000000011111
10000000111000000000000000000001
10000000011111000010000000000001
10000000000111100110000001100101
10110000000001001110000001D00101
11100000011000000000011111111111
11111100011111111111111111111111
11000000001111111111111111111111
10000000000100000000011111111111
10001000000000000000011111111111
10000000000011100111011111111111
10111000011001110110011111011111
10110000011000000000011000001111
10000000000000000000001000001111
10000110000000000110000000001111
10000000100011100111000000000111
11111111111110000001111111111111
11111111111111000011100000011111
100000000000000000L0000110001111
100000000001011111L01000000000L1
100000000001000000L01000000011L1
100000000001001110L00011110011L1
100000000001000000L01000000011L1
100000000000000000L11000000011L1
1000000000000E0000011000011111L1
111110011111111111000111000000L1
11111111111111111111111111111111
11111111111111111111111111111111
