11111111111111111111111111111111
11111111111111111111111111111111
11111111111000111000010000000001
11111111111000000011000000000001
11111111111000000111101110011101
11111011111000000000000111011001
11110000011000000000000000000001
11110000010000011001000000000001
1111000000000001D001000000011001
11100000000111111111101110011101
11111111111111111111111000000111
11111111111111111111110000000011
10000000000100000000001100000011
10000000000000000000001100L00001
10000000000011100111001111L00001
10000000000001110110000000L00011
10000000000000000000000111L00011
10000000000000000000000000L00001
10000000000000000110000000L11101
11111001111011100111000000L10001
11111111111110000001111111111111
10000001111000000001111111111111
10111100111011111110100000000001
10000000000000100000011000000111
10001111100000000000011101010111
10000000000000000000011111111111
11110000100011001110011010100111
11111001100000000000000000000101
10010011100000110110000010000111
1000000000000010E110000111110001
11111111111111111111111111111111
11111111111111111111111111111111
