11111111111111111111111111111111
11111111111111111111111101111101
10L01000000000000000111100010001
11L11000000000100000000000000001
11L00000000111111000100000000001
10L00000000111100001100000000001
10L00000000011000011100000000001
10L00001000000001000000001100101
11110001111000001000000001D00101
11000000001011111100001111111101
11110000011111111111111111111111
10111100001111111111111111111111
10001000011000000000000000000011
1000000000000L000000000010000001
10L0000000011L110000111111100001
10L1111100011L110000111110000111
10L0000100011L110000001100001111
10L0110110011L110000000000000001
10L1110011001L110110000001100001
1111111111000L000110001000000001
11000111111111111111111000000111
11111111111000000000010000000011
10000000000000000000000000000011
100L0000000000000000000111110001
111L11000010010011110000000L0001
111L11000010010011110000000L1111
111L11000000010011110110000L1111
111L11000000E11011110111000L0001
101L1101100111000000000000010001
100L0001100111111111001110111001
11111111111111111111111111111111
11111111111111111111111111111111
