11111111111111111111111111111111
11111111111111111111111111111111
1000000000110000000L010000111111
1000100000000000001L110000011011
111111100000001D001L010000001011
1111100001100111111L010000000011
1011000011100111111L010000000011
1000000000001111111L000000000001
1000011000011111100L000111010011
10100000000111111000001111110111
11100000011111111111111111111111
10000000000111111111111111111111
100000000000L0100000011111111111
100000000001L1100000011111111111
111000000001L0000000011111111111
111L00000000L0000000011111011111
111L11111100L0000000011000001111
100L00000100L0000100001000001111
110L1111001111000111100000001111
110L0000001100000000100000000111
11111111111111000001111111111111
11111111111000000001111111111111
1L000000000011111110100000000001
1L111111100000100000000000000001
1L000000000000000000000000000001
1L000001100000000000000000000001
1L000001110011001110000000000001
1L000100000000000000000000000001
1L110100000000110110000000000001
1111111000000010E110011110011111
11111111111111111111111111111111
11111111111111111111111111111111
