11111111111111111111111111111111
11111111111000000111111101111101
11000000000001100011111100010001
10000000000000000000L00000000001
10111001110000000011L00000000001
10011101100011110011L00000000001
10000000000000000011L00000000001
10000000000000000011L00001100101
10000001100000011111L00001D00101
10111001110111000000L01111111101
11100000011111111111111111111111
11100000000000000111111111111111
11000000000011110011100000000011
11100000111000000000000010000001
10000000000000111110011111100001
100000000L0000000000011110000111
101111111L0111000010001100001111
101000111L0111100110000000000001
111000110L0001001110000001100001
11000000001000000000001000000001
11111111111111111111111000000111
11110000111111111111111100000111
11100000010000000000000110000101
1010000000000L000000000011000001
100L0000L0011L110000101000011101
100L1111L0011L110000101111111101
100L0000L0011L110000000110000001
100L1111L0111L110000000000000001
100L1111L0101L110110000011001001
110L1110L0000L000110000011E11001
11111111111111111111111111111111
11111111111111111111111111111111
