11111111111111111111111111111111
11110111110111111111111111111111
11110001000000000000100000000001
10000000000000100000001110011101
10000000000111111000101111110001
10000000000111100001101111100001
10000000000011000011100100000001
10000110010000001000001000000001
100001D0010000001000001011000001
10111111110011111100000010000011
11111111111111111111111110000011
11111111111000000111110000000011
10L01000000001100011101100000011
11L11000000000000000L01100L00001
11L00000000000000011L01111L00001
10L00000000011110011L00000L00011
10L00000000000000011L00111L00011
10L00001000000000011L00000L00001
11110001111000011111L00000L11101
11000000001111000000L00000L10001
11110000011111111111111111111111
11100000000111000011100000000111
11000000000110000001001111111011
11100000111010000000000010000001
1000000000000L0000L0000000000001
100000000L000L1111L0000000000001
101111111L000L0000L0001100111001
101000111L000L1111L0100000000001
111000110L000L1111L0100011011001
1100000000110L1110L0000010E11001
11111111111111111111111111111111
11111111111111111111111111111111
