11111111111111111111111111111111
11111111111111111111111111111111
10000000000000111000010000111111
11110111111000000011010000011011
11010111111000000111110000001011
10000000111000000000010000000011
10000000011000000000010000000011
10000000000000011001000000000001
1011000000000001D001000111010011
11100000011111111111101111110111
11111100011111111111111111111111
11100000000111111111111111111111
11000000000000000000011111111111
11100000111011100111011111111111
10000000000011111100011111111111
100000000L0011111000011111011111
101111111L0001000000011000001111
101000111L0010000000001000001111
111000110L0010110000000000001111
11000000001000100000100000000111
11111111111111100000111111111111
11110000111100000000111111111111
10000000L00000000000000000000001
11011111L01000100000000000000001
11000000L01000000000000000000001
11001110L00011100001100000000001
11000000L01011000001100000000001
10000000L11000000000000000000001
100E0000011000011000000000000001
11111111000000000010011110011111
11111111111111111111111111111111
11111111111111111111111111111111
