11111111111111111111111111111111
11111111111111111111111111111111
1111111111100000000000000000L001
1111111111101110011101011111L011
1111111111101111110001000000L011
1111101111101111100001001110L001
1111000001100100000001000000L011
1111000001001000000000000000L111
111100000000101100000000000D0111
11100000000000100000111111110001
11111111111111100000111111111111
11111111111011110000111111111111
10000000000000100001100000000011
10000000000000000000000010000001
100000000000L0000000011111100001
100000000000L1111100011110000111
100000000000L0000100001100001111
100000000000L0110110000000000001
100000000000L1110011000001100001
11111001111111111111001000000001
11111111111100011111111000000111
10000001111111111111100000000001
10111100111000000000100000000001
10000000000000100000000000000001
10001111100111111000100100111101
10000000000111100001100100111101
11110000100011000011100100111101
1111100110000000100000E110111101
10010011100000001000011100000001
10000000000011111100011111111101
11111111111111111111111111111111
11111111111111111111111111111111
