11111111111111111111111111111111
11111111111111111111111101111101
10000000001000000000011100010001
1000100000000L000000000000000001
1111111000011L110000100000000001
1111100001111L110000100000000001
1011000011111L110000000000000001
1000000000011L110000000001100101
1000011000001L110110000001D00101
1010000000000L000110001111111101
11100000011111111111111111111111
11000000001000000111111111111111
10000000001001100011100000000011
10011111000000000000L00010000001
1000000L000000000011L11111100001
1000000L111011110011L11110000111
1110000L111000000011L01100001111
1111000L000000000011L00000000001
10000001000000011111L00001100001
10111011100111000000L01000000001
11111111111111111111111000000111
11111111111000000000001111000011
10000000000000000000000010000111
10000000000000000000000000000001
1000000000000100111100L000000001
1000000000000100111100L111110001
1000000000000100111100L000010001
100000000000E110111100L011011001
1000000000011100000000L111001101
11111001111111111111011111111101
11111111111111111111110001111111
11111111111111111111111111111111
