11111111111111111111111111111111
11111111111111111111111111111111
1000000000010000000L010000000001
1000000000000000001L100000000001
100000000000001D001L001110011101
1000000000000111111L000111011001
1000000000000111111L000000000001
1000000000001111111L000000000001
1000000000011111100L000000011001
11111001111111111000001110011101
11111111111111111111111000000111
11111111111111111111110000000011
11000000000000000000001100000011
1000000000000L000000001100L00001
1011100111011L110000101111L00001
1001110110011L110000100000L00011
1000000000011L110000000111L00011
1000000000011L110000000000L00001
1000000110001L110110000000L11101
1011100111000L000110000000L10001
11100000011111111111111111111111
11000000001111000001111111111111
10110000001111000000111111111111
101100L0000110000000011111111111
101111L0000000011111011111111111
100000L0001000001110011111011111
100111L0001010000000011000001111
100000L0000010E00110001000001111
100000L1110111101100000000001111
100000L1000111100001000000000111
11111111111111111111111111111111
11111111111111111111111111111111
