11111111111111111111111111111111
11111111111000000111111111111111
11000000000001100011100011100001
10000000000000000000L00000001101
10111001110000000011L00000011111
10011101100011110011L00000000001
10000000000000000011L00000000001
10000000000000000011L00001100101
10000001100000011111L00001D00101
10111001110111000000L11111111111
11100000011111111111111111111111
10000000000111111111111111111111
10000000000000000000011111111111
10000000000011100111011111111111
11100000000011111100011111111111
111L0000000011111000011111011111
111L1111110001000000011000001111
100L0000010010000000001000001111
110L1111001010110000000000001111
110L0000001000100000100000000111
11111111111111100000111111111111
11110000111001100111011111111111
11100000010000000010000000000001
10100000000111111011100000000001
100L0000L00010000000000000000001
100L1111L00000001111100000000001
100L0000L00000000000000000000001
100L1111L01000010000000000000001
100L1111L01000110000000000000001
110L1110L000011111E0111110011111
11111111111111111111111111111111
11111111111111111111111111111111
