11111111111111111111111111111111
11111111111000000111111100000001
10L01000000001100011111100100001
11L11000000000000000L10001111001
11L00000000000000011L10000000001
10L00000000011110011L10000010111
10L00000000000000011L00000L10D11
10L00001000000000011L11111L11111
11110001111000011111L00011L11111
11000000001111000000L00000L00111
11110000011111111111111111111111
11000000001000000111111111111111
10000000001011110011100000000001
10011111000000000000001110011101
1000000L000000111110001111110001
1000000L111000000000001111100001
1110000L111111000010000100000001
1111000L000111100110001000000001
10000001000001001110001011000001
10111011100000000000000010000011
11111111111111111111111110000011
11110000011111111111111000000001
11110000001000000000010000000001
1110000000000L000000011000001111
1000011111011L110000100000000001
1000001110011L110000100000000L01
1010000000011L110000001111111L01
1010E00110011L110000001000111L01
1111101100001L110110011000110L01
1111100001000L000110010000000011
11111111111111111111111111111111
11111111111111111111111111111111
