11111111111111111111111111111111
11110000000111111111100000000001
11110010000100000000000000011001
11000111100000000000010001L01001
11000000000011100111000000L00001
11000001011001110110000000L11001
100000L10D1000000000001110L11001
111111L1111000000000001010L11001
100011L1111000000110000000011111
100000L0011011100111000000011011
11111111111110000001111111111111
11111111111110000000011111111111
11111111111100000000000000000011
11111111111110000011100010000001
11111111111000000000011111100001
1111101111100000000L011110000111
1111000001101111111L001100001111
1111000001001000111L000000000001
1111000000011000110L000001100001
11100000000100000000101000000001
11111111111111111111111000000111
11111111111111000011101111000011
100000000000000000L0000010000111
100000000001011111L0100000000001
100000000001000000L010L000000001
100000000001001110L000L111110001
100000000001000000L010L000010001
100000000000000000L110L011011001
1000000000000E00000110L111001101
11111001111111111100011111111101
11111111111111111111110001111111
11111111111111111111111111111111
