11111111111111111111111111111111
11111111111111111111111111111111
10L01000000000000000111100000001
11L11000000000100000011000000001
11L00000000111111000111000LD1111
10L00000000111100001100000L11111
10L00000000011000011100000L11111
10L00001000000001000001100L00111
11110001111000001000011111111111
11000000001011111100000011100011
11110000011111111111111111111111
10111100001111111111111111111111
10001000011000000000110000000001
10000000000000100000000000000001
10L00000000111111000101110011101
10L11111000111100001100111011001
10L00001000011000011100000000001
10L01101100000001000000000000001
10L11100110000001000000000011001
11111111110011111100001110011101
11000111111111111111111000000111
11111111111111000001111000000001
10000000000001100001010000000001
10000000000000110000011000001111
10000000000010000111000000000001
10000000000011111111000000000L01
10000000000001100000001111111L01
10000000000000000000001000111L01
10000000000000110010011000110L01
1111100111100011E110010000000011
11111111111111111111111111111111
11111111111111111111111111111111
