11111111111111111111111111111111
11111111111111111111100000000001
10L01000000000111000000000011001
11L11000000000000011010001L01001
11L00000000000000111100000L00001
10L00000000000000000000000L11001
10L00000000000000000001110L11001
10L00001000000011001001010L11001
1111000111100001D001000000011111
11000000001111111111100000011011
11110000011111111111111111111111
11000000001111111111111111111111
10110000001000000000011111111111
101100L0000111011111111111111111
101111L0000101011111111111111111
100000L0001000000011111111011111
100111L0001000000001111000001111
100000L0000000000000001000001111
100000L1110011000000000000001111
100000L1000110000001100000000111
11111111111111110001111111111111
11111111111100000000100110011101
10000000000000000000000000001001
10000000000000100000011111101111
10000000000000000000001000000001
10000000000011100001100000111111
10000000000011000001100000000001
10000000000000000000000001000001
10000000000000011000000011000001
1111100111100000001000011111E011
11111111111111111111111111111111
11111111111111111111111111111111
