11111111111111111111111111111111
11110111110000000111111111111111
11110001000011110011100000000011
10000000000000000000000010000001
10000000000000111110011111100001
10000000000000000000011110000111
10000000000111000010001100001111
10000110010111100110000000000001
100001D0010001001110000001100001
10111111110000000000001000000001
11111111111111111111111000000111
11111111111111000011110000000011
11000000000110000001000000000001
10000000000010000000000010000001
1011100111000L0000L0000000000001
1001110110000L1111L0001110000111
1000000000000L0000L0001100000111
1000000000000L1111L0100000000001
1000000110000L1111L0100001100001
1011100111010L1110L0000000001001
11100000011111111111111111111111
11110000111111111111111111111111
10000000L00L00000000000000000001
11011111L01L11111110000000000001
11000000L01L00000000000000000001
11001110L00L00000110000000000001
11000000L01L00000111000000000001
10000000L11L00010000000000000001
100E0000011L11010000000000000001
11111111000111111000011110011111
11111111111111111111111111111111
11111111111111111111111111111111
