11111111111111111111111111111111
11111111111111111111111111111111
10000000L000000000L0010000000001
11011111L011011111L0100000000001
11000000L011000000L0101110011101
11001110L001001110L0000111011001
11000000L011000000L0100000000001
10000000L010000000L1100000000001
10000000111000000D01100000011001
11111111111111111100001110011101
11111111111111111111111000000111
11111111111111111111111000000001
11111111111100000000010000000001
11111111111000000000011000001111
11111111111011100111000000000001
11111011111001110110000000000L01
11110000011000000000001111111L01
11110000010000000000001000111L01
11110000000000000110011000110L01
11100000000011100111010000000011
11111111111110000001111111111111
11111111111111000001100000011111
10000000000111000000100110001111
100000000001100000000000000000L1
100000000000000111110000000011L1
100000000000000011100011110011L1
100000000000100000000000000011L1
10000000000010E001100000000011L1
100000000001111011000000011111L1
111110011111111000010111000000L1
11111111111111111111111111111111
11111111111111111111111111111111
