11111111111111111111111111111111
11111111111111111111111100000001
10000000000000000000011100100001
10000000000011100111010001111001
10000000000011111100010000000001
10000000000011111000010000010111
10000000000001000000000000L10D11
10000000000010000000011111L11111
10000000000010110000000011L11111
11111001111000100000100000L00111
11111111111111100000111111111111
11111111111100000000111111111111
11000000000000000000111111111111
10000000000001111100011111111111
10111001110000000L00011111111111
10011101100000000L11111111011111
10000000000110000L11111000001111
10000000000111000L00001000001111
10000001100000000100000000001111
10111001110011101110000000000111
11100000011111111111111111111111
11110000011111111111111111111111
111100000010000000000L0000000001
1110000000000L0000000L1111111001
1000011111011L1100001L0000000001
1000001110011L1100001L0000011001
1010000000011L1100000L0000011101
1010E00110011L1100000L0001000001
1111101100001L1101100L1101000001
1111100001000L000110011111100001
11111111111111111111111111111111
11111111111111111111111111111111
