11111111111111111111111111111111
11111111111111111111111111111111
11111111111100000000010000000L01
11111111111000000000000000001L11
1111111111101110011100001D001L01
11111011111001110110000111111L01
11110000011000000000000111111L01
11110000010000000000001111111L01
11110000000000000110011111100L01
11100000000011100111011111100001
11111111111110000001111111111111
11111111111000000000011111111111
10000000000000000000000000000001
10000000000000000000011101111111
10000000000110000000010101111111
1000000000011L000000000000001111
1000000000011L111111000000000111
1000000000000L000001000000000001
1000000000010L111100101100000001
1111100111110L000000111000000111
11111111111111111111111111000111
11110000111111000001110000000011
11100000010001100001000000000011
10100000000000110000000111110001
100L0000L000100001110000000L0001
100L1111L000111111110000000L1111
100L0000L000011000000110000L1111
100L1111L010000000000111000L0001
100L1111L01000110010000000010001
110L1110L0000011E110001110111001
11111111111111111111111111111111
11111111111111111111111111111111
