11111111111111111111111111111111
11111111111111111111111111111111
1000000000010000000L000000000001
1000000000000000001L111101111111
100000000000001D001L010101111111
1000000000000111111L000000001111
1000000000000111111L000000000111
1000000000001111111L000000000001
1000000000011111100L001100000001
11111001111111111000011000000111
11111111111111111111111111000111
11111111111111000011100000000001
10000000000110000001000000000001
11110111111010000000000000000001
1101011111100L0000L0011000000001
1000000011100L1111L0011L00000001
1000000001100L0000L0011L11111101
1000000000000L1111L0100L00000101
1011000000000L1111L0110L11110011
1110000001110L1110L0010L00000011
11111100011111111111111111111111
11100000000000000111111100001111
1100000000001111001110000000L001
1110000011100000000001011111L011
1000000000000011111001000000L011
100000000L000000000001001110L001
101111111L011100001001000000L011
101000111L011110011000000000L111
111000110L0001001110000E00000111
11000000001000000000011111110001
11111111111111111111111111111111
11111111111111111111111111111111
