11111111111111111111111111111111
11111111111111111111111111111111
10000000L000L0100000011111111111
11011111L011L1100000011111111111
11000000L011L0000000011111111111
11001110L000L0000000011111011111
11000000L010L0000000011000001111
10000000L110L0000100001000001111
1000000D011111000111100000001111
11111111000100000000100000000111
11111111111111000001111111111111
11111111111100000000111111111111
10000000000000000000100000000001
10000000000001111100001110011101
10000000000000000L00001111110001
10000000000000000L11101111100001
10000000000110000L11100100000001
10000000000111000L00001000000001
10000000000000000100001011000001
11111001111011101110000010000011
11111111111111111111111110000011
11111111111111111111111100000111
1L000000000000000000111100000011
1L111111100000100000011000000001
1L000000000111111000100001111101
1L000001100111100001100000111001
1L000001110011000011101000000001
1L0001000000000010000010E0011001
1L110100000000001000011110110001
11111110000011111100011110000101
11111111111111111111111111111111
11111111111111111111111111111111
