11111111111111111111111111111111
11111111111111111111111111111111
10001110000L00000000000000000011
10000000110L11111110000010000001
10000001111L00000000011111100001
10000000000L00000110011110000111
10000000000L00000111001100001111
10000110010L00010000000000000001
100001D0010L11010000000001100001
11111111111111111000001000000001
11111111111111111111111000000111
11111111111111111111101111000011
11111111111000000000100010000111
11111111111000100000000000000001
1111111111111111100000L000000001
1111101111111110000110L111110001
1111000001101100001110L000010001
1111000001000000000000L011011001
1111000000000001100000L111001101
11100000000010000000011111111101
11111111111110000001110001111111
11111111111100000000111100000111
10000000000000000000011100000011
10000000000000100000011000000001
10000000000000000000000001111101
10000000000011100001100000111001
10000000000011000001101000000001
100000000000000000000010E0011001
10000000000000011000011110110001
11111001111000000010011110000101
11111111111111111111111111111111
11111111111111111111111111111111
