11111111111111111111111111111111
11111111111111111111111111111111
111111111110000000L0000000000001
111111111111011111L0111101111111
111111111111000000L0110101111111
111110111111001110L0000000001111
111100000111000000L0100000000111
111100000100000000L1100000000001
11110000000000000D01101100000001
11100000000111111100011000000111
11111111111111111111111111000111
11111111111111111111110000000011
10000000000100000000000000000001
10000000000000000000000010000001
10000000000011100111000000000001
10000000000001110110001110000111
10000000000000000000001100000111
10000000000000000000000000000001
10000000000000000110000001100001
11111001111011100111000000001001
11111111111110000001111111111111
10000000000011110000111111111111
1000000000000010000110000000L001
1000000000000000000001011111L011
100100111100L000000001000000L011
100100111100L111110001001110L001
100100111100L000010001000000L011
10E110111100L011011000000000L011
111100000000L1110011000000001111
11111111110111111111011111111111
11111111111100011111111111111111
11111111111111111111111111111111
