11111111111111111111111111111111
11111111111000000111111111111111
10000000001001100011100011100001
10001000000000000000L00000001101
11111110000000000011L00000011111
11111000011011110011L00000000001
10110000111000000011L00000000001
10000000000000000011L00001100101
10000110000000011111L00001D00101
10100000000111000000L11111111111
11100000011111111111111111111111
10000000000111111111111111111111
10000000000000000000111111111111
10000000000000100000011111111111
11100000000111111000011111111111
111L0000000111100001111111011111
111L1111110011000011111000001111
100L0000010000000000001000001111
110L1111001000011000000000001111
110L0000001010000000000000000111
11111111111110000001111111111111
10000001111111000001111111111111
10011000111001100001000000000001
1000000000L000110000000000000001
1000000011L010000111000000000001
1011110011L011111111000000000001
1000000011L001100000000000000001
1000000011L000000000000000000001
1000011111L000110010000000000001
1111000000L00011E110011110011111
11111111111111111111111111111111
11111111111111111111111111111111
