11111111111111111111111111111111
11111111111111111111111101111101
10000000001000000000111100010001
10001000000000100000000000000001
11111110000111111000100000000001
11111000011111100001100000000001
10110000111011000011100000000001
10000000000000001000000001100101
10000110000000001000000001D00101
10100000000011111100001111111101
11100000011111111111111111111111
10000000000000000111111111111111
10000000000011110011100000000001
10000000000000000000001110011101
11100000000000111110001111110001
111L0000000000000000001111100001
111L1111110111000010000100000001
100L0000010111100110001000000001
110L1111001001001110001011000001
110L0000001000000000000010000011
11111111111111111111111110000011
11111111111111000011100000000001
100000000000000000L0000000000001
100000000001011111L0100000000001
100000000001000000L0111000000001
100000000001001110L0011L00000001
100000000001000000L0111L11111101
100000000000000000L1100L00000101
1000000000000E000001110L11110011
11111001111111111100010L00000011
11111111111111111111111111111111
11111111111111111111111111111111
