11111111111111111111111111111111
11111111111111111111111111111111
10L01000000111000000000000000001
11L11000000110000000000000000001
11L0000000011000LD11100000000001
10L0000000000000L111100000000001
10L0000000000000L111100000000001
10L0000100001100L001100000000001
11110001111111111111100000000001
11000000001000111000111110011111
11110000011111111111111111111111
11000000001111111111111111111111
1000000000000000000000L010000001
1000100000000L00000001L110000001
1000000000011L11000011L000000001
1011100001111L11000010L000000001
1011000001111L11000000L000000001
1000000000011L11000000L000010001
1000011000001L110110011100011111
1000000010000L000110010000000011
11111111111111111111111100000111
11111111111000000111111100001111
1000000000100110001110000000L001
10001000000000000000L1011111L011
11111110001000000011L1000000L011
11111000011011110011L1001110L001
10110000111000000011L1000000L011
10000010000000000011L0000000L111
10000010000000011111L00E00000111
10111111000111000000L11111110001
11111111111111111111111111111111
11111111111111111111111111111111
