11111111111111111111111111111111
11111111111111000011111111111111
11000000000110000001010000000L01
10000000000010000000000000001L11
1011100111000L0000L000001D001L01
1001110110000L1111L0000111111L01
1000000000000L0000L0000111111L01
1000000000000L1111L0101111111L01
1000000110000L1111L0111111100L01
1011100111010L1110L0011111100001
11100000011111111111111111111111
10111100001111111111111111111111
10001000011000000000100000000001
10000000000000100000001110011101
10L00000000111111000101111110001
10L11111000111100001101111100001
10L00001000011000011100100000001
10L01101100000001000001000000001
10L11100110000001000001011000001
11111111110011111100000010000011
11000111111111111111111110000011
10000000000000000111110000000011
10000000000001100011100000000011
10000000000000000000L00111110001
10010011110000000011L000000L0001
10010011110011110011L000000L1111
10010011110000000011L110000L1111
10E11011110000000011L111000L0001
11110000000000011111L00000010001
11111111110111000000L01110111001
11111111111111111111111111111111
11111111111111111111111111111111
