11111111111111111111111111111111
11111111111111000011111111111111
110000000L0110000001000000000001
100000001L1010000000011101111111
10001D001L000L0000L0010101111111
100111111L000L1111L0000000001111
100111111L000L0000L0000000000111
101111111L000L1111L0100000000001
111111100L000L1111L0101100000001
1111111000010L1110L0011000000111
11111111111111111111111111000111
11111111111111111111101111000011
11111111111000000000000010000111
11111111111111011111100000000001
1111111111110101111110L000000001
1111101111100000001110L111110001
1111000001100000000110L000010001
1111000001000000000000L011011001
1111000000001100000000L111001101
11100000000110000001111111111101
11111111111111110001110001111111
11111111111100000000111100001111
1000000000000000000010000000L001
1000000000000111110001011111L011
10000000000000000L0001000000L011
10000000000000000L1111001110L001
10000000000110000L1111000000L011
10000000000111000L0000000000L111
10000000000000000100000E00000111
11111001111011101110011111110001
11111111111111111111111111111111
11111111111111111111111111111111
