11111111111111111111111111111111
11111111111111111111111111111111
1000000000010000000L000000000011
1000000000000000001L100010000001
100000000000001D001L011111100001
1000000000000111111L011110000111
1000000000000111111L001100001111
1000000000001111111L000000000001
1000000000011111100L000001100001
11111001111111111000001000000001
11111111111111111111111000000111
11111111111000000111110000000011
10000000001001100011100000000011
10001000000000000000L00111110001
11111110000000000011L000000L0001
11111000011011110011L000000L1111
10110000111000000011L110000L1111
10000000000000000011L111000L0001
10000110000000011111L00000010001
10100000000111000000L01110111001
11100000011111111111111111111111
11110000111000000111111111111111
10000000L000111100111L0000000001
11011111L010000000000L1111111001
11000000L010001111100L0000000001
11001110L000000000000L0000011001
11000000L011110000100L0000011101
10000000L111111001100L0001000001
100E00000110010011100L1101000001
11111111000000000000011111100001
11111111111111111111111111111111
11111111111111111111111111111111
