11111111111111111111111111111111
11111111111111111111111111111111
10000000000000000000010000000L01
1111011111100L000000000000001L11
1101011111111L11000010001D001L01
1000000011111L110000100111111L01
1000000001111L110000000111111L01
1000000000011L110000001111111L01
1011000000001L110110011111100L01
1110000001100L000110011111100001
11111100011111111111111111111111
11000000001111111111111111111111
10110000001100000000011111111111
101100L0000000000000011111111111
101111L0000011100111011111111111
100000L0001001110110011111011111
100111L0001000000000011000001111
100000L0000000000000001000001111
100000L1110000000110000000001111
100000L1000011100111000000000111
11111111111110000001111111111111
10000000011011110000111111111111
10111111101000100001100000000001
10001000000000000000000000000001
100000000000L0000000000000000001
100000000000L1111100000000000001
101100111000L0000100000000000001
100000000000L0110110000000000001
100011011000L1110011000000000001
100010E1100111111111011110011111
11111111111100011111111111111111
11111111111111111111111111111111
