11111111111111111111111111111111
11111111111111111111111111111111
10000000000L00000000010000000L01
10111001110L11111110000000001L11
10111111000L0000000000001D001L01
10111110000L00000110000111111L01
10010000000L00000111000111111L01
10100000000L00010000001111111L01
10101100000L11010000011111100L01
10001000001111111000011111100001
11111000001111111111111111111111
11000000001111111111111111111111
10000000001100000000011111111111
10011111000000000000011111111111
1000000L000011100111011111111111
1000000L111001110110011111011111
1110000L111000000000011000001111
1111000L000000000000001000001111
10000001000000000110000000001111
10111011100011100111000000000111
11111111111110000001111111111111
11111111111100000000100000000111
10000000000000000000101111111011
10000000000001111100000010000001
10000000000000000L00000000000001
10000000000000000L11100000000001
10000000000110000L11101100111001
10000000000111000L00000000000001
10000000000000000100000011011001
11111001111011101110000010E11001
11111111111111111111111111111111
11111111111111111111111111111111
