11111111111111111111111111111111
11111111111111111111111111111111
10L01000000000111000011111111111
11L11000000000000011011111111111
11L00000000000000111111111111111
10L00000000000000000011111011111
10L00000000000000000011000001111
10L00001000000011001001000001111
1111000111100001D001000000001111
11000000001111111111100000000111
11110000011111111111111111111111
11000000001000000111111111111111
10000000000001100011100000000001
10001000000000000000L11101111111
10000000000000000011L10101111111
10111000011011110011L00000001111
10110000011000000011L00000000111
10000000000000000011L00000000001
10000110000000011111L01100000001
10000000100111000000L11000000111
11111111111111111111111111000111
11111111111111000001110000000011
10000000000001100001000000000001
10000000000000110000000010000001
10000000000010000111000000000001
10000000000011111111001110000111
10000000000001100000001100000111
10000000000000000000000000000001
10000000000000110010000001100001
1111100111100011E110000000001001
11111111111111111111111111111111
11111111111111111111111111111111
