11111111111111111111111111111111
11111111111000000111111100000001
10L01000000001100011111100100001
11L11000000000000000L10001111001
11L00000000000000011L10000000001
10L00000000011110011L10000010111
10L00000000000000011L00000L10D11
10L00001000000000011L11111L11111
11110001111000011111L00011L11111
11000000001111000000L00000L00111
11110000011111111111111111111111
11000000001111111111111111111111
10000000000000000000100000000001
10001000000000100000011101111111
10000000000111111000110101111111
10111000011111100001100000001111
10110000011011000011100000000111
10000000000000001000000000000001
10000110000000001000001100000001
10000000100011111100011000000111
11111111111111111111111111000111
10000001111111000011100110011101
10111100111110000001000000001001
10000000000010000000011111101111
1000111110000L0000L0001000000001
1000000000000L1111L0000000111111
1111000010000L0000L0000000000001
1111100110000L1111L0100001000001
1001001110000L1111L0100011000001
1000000000010L1110L000011111E011
11111111111111111111111111111111
11111111111111111111111111111111
