11111111111111111111111111111111
10000000000111111111111111111111
10000001100100000000011100000001
110001L0100000000000011000000001
100000L0000011100111011000LD1111
100000L1100001110110000000L11111
101110L1100000000000000000L11111
101010L1100000000000001100L00111
10000001111000000110011111111111
10000001101011100111000011100011
11111111111110000001111111111111
11111111111000000000011111111111
11111111111000000000000000000011
11111111111000000000000010000001
11111111111110000000011111100001
1111101111111L000000011110000111
1111000001111L111111001100001111
1111000001000L000001000000000001
1111000000010L111100100001100001
1110000000010L000000101000000001
11111111111111111111111000000111
11111111111000000000010000000011
10000000000000000000001100000011
10000000000000000000001100L00001
10000000000001001111001111L00001
10000000000001001111000000L00011
10000000000001001111000111L00011
100000000000E1101111000000L00001
10000000000111000000000000L11101
11111001111111111111000000L10001
11111111111111111111111111111111
11111111111111111111111111111111
