11111111111111111111111111111111
11111111111111111111111111111111
10000000000111000000000000000001
10000000000110000000011101111111
1000000000011000LD11110101111111
1000000000000000L111100000001111
1000000000000000L111100000000111
1000000000001100L001100000000001
10000000000111111111101100000001
11111001111000111000111000000111
11111111111111111111111111000111
11111111111111111111110000000011
10L01000000000000000100000000011
11L11000000000100000000111110001
11L000000001111110001000000L0001
10L000000001111000011000000L1111
10L000000000110000111110000L1111
10L000010000000010000111000L0001
11110001111000001000000000010001
11000000001011111100001110111001
11110000011111111111111111111111
10000000000000000111111111111111
10000000000011110011111111111111
10000000000000000000011111111111
10010011110000111110011111111111
10010011110000000000011111011111
10010011110111000010011000001111
10E11011110111100110001000001111
11110000000001001110000000001111
11111111110000000000000000000111
11111111111111111111111111111111
11111111111111111111111111111111
