11111111111111111111111111111111
11111111111111111111111111111111
10000000000000111000000000000011
10000000000000000011000010000001
10000000000000000111111111100001
10000000000000000000011110000111
10000000000000000000001100001111
10000000000000011001000000000001
1000000000000001D001000001100001
11111001111111111111101000000001
11111111111111111111111000000111
11111111111000000111111000000001
10000000000001100011110000000001
10111001110000000000L11000001111
10111111000000000011L00000000001
10111110000011110011L00000000L01
10010000000000000011L01111111L01
10100000000000000011L01000111L01
10101100000000011111L11000110L01
10001000001111000000L10000000011
11111000001111111111111111111111
11000000001000000000011111111111
10110000001000000000011111111111
101100L0000000000000011111111111
101111L0000001001111011111111111
100000L0001001001111011111011111
100111L0001001001111011000001111
100000L00000E1101111001000001111
100000L1110111000000000000001111
100000L1000111111111000000000111
11111111111111111111111111111111
11111111111111111111111111111111
