11111111111111111111111111111111
11111111111111000011111111111111
10000000000110000001011100000001
11110111111010000000011000000001
1101011111100L0000L0011000LD1111
1000000011100L1111L0000000L11111
1000000001100L0000L0000000L11111
1000000000000L1111L0101100L00111
1011000000000L1111L0111111111111
1110000001110L1110L0000011100011
11111100011111111111111111111111
11000000001111111111111111111111
10110000001000000000010000000001
101100L000000L000000000000000001
101111L000011L110000101110011101
100000L000111L110000100111011001
100111L000111L110000000000000001
100000L000011L110000000000000001
100000L111001L110110000000011001
100000L100000L000110001110011101
11111111111111111111111000000111
11111111111000000111100000000001
10000000001001100011100000000001
10001000000000000000L00000000001
11111110001000000011L00100111101
11111000011011110011L00100111101
10110000111000000011L00100111101
10000010000000000011L0E110111101
10000010000000011111L11100000001
10111111000111000000L11111111101
11111111111111111111111111111111
11111111111111111111111111111111
