11111111111111111111111111111111
11111111111111111111111111111111
1111111111110000000L000000000011
1111111111100000001L100010000001
111111111110001D001L011111100001
1111101111100111111L011110000111
1111000001100111111L001100001111
1111000001001111111L000000000001
1111000000011111100L000001100001
11100000000111111000001000000001
11111111111111111111111000000111
11111111111111111111110000000011
10000000000100000000001100000011
10000000000000000000001100L00001
10000000000011100111001111L00001
10000000000001110110000000L00011
10000000000000000000000111L00011
10000000000000000000000000L00001
10000000000000000110000000L11101
11111001111011100111000000L10001
11111111111110000001111111111111
11111111111111000001111111111111
1L000000000111000000110000111111
1L111111100110000000010000011011
1L000000000000011111010000001011
1L000001100000001110010000000011
1L000001110010000000010000000011
1L000100000010E00110000000000001
1L110100000111101100000111010011
11111110000111100001001111110111
11111111111111111111111111111111
11111111111111111111111111111111
