11111111111111111111111111111111
11111111111111111111111111111111
10000000000000000000110000000L01
10000000000000100000000000001L11
1000000000011111100000001D001L01
10000000000111100001100111111L01
10000000000011000011100111111L01
10000000000000000000001111111L01
10000000000000011000011111100L01
11111001111010000000011111100001
11111111111110000001111111111111
11111111111000000000011111111111
10L01000000000000000011111111111
11L11000000000000000011111111111
11L00000000110000000011111111111
10L0000000011L000000011111011111
10L0000000011L111111011000001111
10L0000100000L000001001000001111
1111000111110L111100100000001111
1100000000110L000000100000000111
11110000011111111111111111111111
11000000001111111111111100001111
1011000000100000000010000000L001
101100L000000010000001011111L011
101111L000011111100011000000L011
100000L000111110000111001110L001
100111L000101100001111000000L011
100000L000000000100000000000L111
100000L1110000001000000E00000111
100000L1000011111100011111110001
11111111111111111111111111111111
11111111111111111111111111111111
