11111111111111111111111111111111
11111111111000000111111111111111
10001110000011110011100000000011
10000000110000000000000010000001
10000001111000111110011111100001
10000000000000000000011110000111
10000000000111000010001100001111
10000110010111100110000000000001
100001D0010001001110000001100001
11111111111000000000001000000001
11111111111111111111111000000111
11111111111111111111110000000011
10000000000100000000000000000001
10000000000000000000000010000001
10000000000011100111000000000001
10000000000001110110001110000111
10000000000000000000001100000111
10000000000000000000000000000001
10000000000000000110000001100001
11111001111011100111000000001001
11111111111110000001111111111111
11111111111111000001111111111111
10000000000111000000111111111111
100L0000000110000000011111111111
111L1100001000011111011111111111
111L1100001000001110011111011111
111L1100000010000000011000001111
111L1100000010E00110001000001111
101L1101100111101100000000001111
100L0001100111100001000000000111
11111111111111111111111111111111
11111111111111111111111111111111
