11111111111111111111111111111111
11111111111111111111111111111111
10000000000000111000000000000001
10000000000000000011001110011101
10000000000000000111101111110001
10000000000000000000001111100001
10000000000000000000000100000001
10000000000000011001001000000001
1000000000000001D001001011000001
11111001111111111111100010000011
11111111111111111111111110000011
11111111111111111111100000000001
10000000001000000000100000000001
10001000000000100000000000000001
11111110000111111000111000000001
11111000011111100001111L00000001
10110000111011000011111L11111101
10000000000000001000000L00000101
10000110000000001000010L11110011
10100000000011111100010L00000011
11100000011111111111111111111111
10000000011111000011111111111111
10111111101110000001011111111111
10001000000010000000011111111111
1000000000000L0000L0011111111111
1000000000000L1111L0011111011111
1011001110000L0000L0011000001111
1000000000000L1111L0101000001111
1000110110000L1111L0100000001111
100010E110010L1110L0000000000111
11111111111111111111111111111111
11111111111111111111111111111111
