11111111111111111111111111111111
11110000000111111111111111111111
11110010000000000000100000000001
11000111100000100000001110011101
11000000000111111000101111110001
11000001011111100001101111100001
100000L10D1011000011100100000001
111111L1111000001000001000000001
100011L1111000001000001011000001
100000L0011011111100000010000011
11111111111111111111111110000011
11111111111111111111110000000011
11000000000L00000000000000000001
10000000000L11111110000010000001
10111001110L00000000000000000001
10011101100L00000110001110000111
10000000000L00000111001100000111
10000000000L00010000000000000001
10000001100L11010000000001100001
10111001110111111000000000001001
11100000011111111111111111111111
10000000011111111111111111111111
10111111101L00000000000000000001
10001000000L11111110000000000001
10000000000L00000000000000000001
10000000000L00000110000000000001
10110011100L00000111000000000001
10000000000L00010000000000000001
10001101100L11010000000000000001
100010E1100111111000011110011111
11111111111111111111111111111111
11111111111111111111111111111111
