11111111111111111111111111111111
11111111111111111111111101111101
11111111111000000000111100010001
11111111111000100000000000000001
11111111111111111000000000000001
11111011111111100001100000000001
11110000011011000011100000000001
11110000010000000000000001100101
11110000000000011000000001D00101
11100000000010000000001111111101
11111111111110000001111111111111
11111111111100000000111111111111
10000000000011000000110000000001
1000000000001100L000000000000001
1000000000001111L000001110011101
1000000000000000L000100111011001
1000000000000111L000100000000001
1000000000000000L000000000000001
1000000000000000L111000000011001
1111100111100000L100001110011101
11111111111111111111111000000111
11111111111000000111111100001111
1000000000000110001110000000L001
100L0000000000000000L1011111L011
111L1100001000000011L1000000L011
111L1100001011110011L1001110L001
111L1100000000000011L1000000L011
111L1100000000000011L0000000L111
101L1101100000011111L00E00000111
100L0001100111000000L11111110001
11111111111111111111111111111111
11111111111111111111111111111111
