11111111111111111111111111111111
10000000000111111111111101111101
10000001100000000000011100010001
110001L0100011100111000000000001
100000L0000011111100000000000001
100000L1100011111000000000000001
101110L1100001000000000000000001
101010L1100010000000000001100101
10000001111010110000000001D00101
10000001101000100000101111111101
11111111111111100000111111111111
11111111111000000000011111111111
1111111111100000000000L010000001
1111111111100000000001L110000001
1111111111111000000001L000000001
1111101111111L00000000L000000001
1111000001111L11111100L000000001
1111000001000L00000100L000010001
1111000000010L111100111100011111
1110000000010L000000110000000011
11111111111111111111111100000111
11111111111111000011100000000001
100000000000000000L0000000000001
100000000001011111L0100000000001
100000000001000000L0111000000001
100000000001001110L0011L00000001
100000000001000000L0111L11111101
100000000000000000L1100L00000101
1000000000000E000001110L11110011
11111001111111111100010L00000011
11111111111111111111111111111111
11111111111111111111111111111111
