11111111111111111111111111111111
11111111111111111111111111111111
11110000000000000000111111111111
11100000000000100000011111111111
111000LD111111111000011111111111
100000L1111111100001111111011111
100000L1111011000011111000001111
101100L0011000000000001000001111
11111111111000011000000000001111
10001110001010000000000000000111
11111111111110000001111111111111
11111111111100000000111111111111
10000000001011000000100000000001
1000100000001100L000000000000001
1111111000001111L000000000000001
1111100001100000L000100000000001
1011000011100111L000100000000001
1000000000000000L000000000000001
1000011000000000L111000000000001
1010000000000000L100011110011111
11100000011111111111111111111111
10111100001000000001111100001111
10001000011011111110111000000101
10000000000000100000001000000001
10L00000000000000000000L0000L001
10L11111000000000000000L1111L001
10L00001000011001110000L0000L001
10L01101100000000000000L1111L011
10L11100110000110110000L1111L011
1111111111000010E110010L1110L001
11000111111111111111111111111111
11111111111111111111111111111111
