11111111111111111111111111111111
11111111111111111111111111111111
10001110000000000000100000000001
10000000110000100000011000000111
10000001111111111000011101010111
10000000000111100001111111111111
10000000000011000011111010100111
10000110010000000000000000000101
100001D0010000011000000010000111
11111111111010000000000111110001
11111111111110000001111111111111
11111111111000000000011111111111
10000000001000000000011111111111
10001000000000000000011111111111
11111110000110000000011111111111
1111100001111L000000011111011111
1011000011111L111111011000001111
1000000000000L000001001000001111
1000011000010L111100100000001111
1010000000010L000000100000000111
11100000011111111111111111111111
11100000000111000001111111111111
11000000000111000000100000000001
11100000111110000000000000000001
10000000000000011111000000000001
100000000L0000001110000000000001
101111111L0010000000000000000001
101000111L0010E00110000000000001
111000110L0111101100000000000001
11000000001111100001011110011111
11111111111111111111111111111111
11111111111111111111111111111111
