11111111111111111111111111111111
11111111111111111111111111111111
100000000000000000L0000000000011
100000000001011111L0100010000001
100000000001000000L0111111100001
100000000001001110L0011110000111
100000000001000000L0101100001111
100000000000000000L1100000000001
10000000000000000D01100001100001
11111001111111111100001000000001
11111111111111111111111000000111
11111111111111111111100000000001
10000000000L00000000000000000001
10111001110L11111110000000000001
10111111000L00000000011000000001
10111110000L00000110011L00000001
10010000000L00000111011L11111101
10100000000L00010000000L00000101
10101100000L11010000010L11110011
10001000001111111000010L00000011
11111000001111111111111111111111
11110000011111111111111111111111
10011000010L00000000011111111111
10001100000L11111110011111111111
10100001110L00000000011111111111
10111111110L00000110011111011111
10011000000L00000111011000001111
10000000000L00010000001000001111
10001100100L11010000000000001111
100011E1100111111000000000000111
11111111111111111111111111111111
11111111111111111111111111111111
