11111111111111111111111111111111
11111111111111011111011111111111
10000000000111000100000000000001
10111001110000000000000000000001
10111111000000000000000000000001
10111110000000000000000000000001
10010000000000000000000000000001
10100000000000011001000000000001
1010110000000001D001000000000001
10001000001011111111011110011111
11111000001111111111111111111111
11100000000000000111111111111111
11000000000001100011100000000001
11100000111000000000L01110011101
10000000000000000011L01111110001
100000000L0011110011L01111100001
101111111L0000000011L00100000001
101000111L0000000011L01000000001
111000110L0000011111L01011000001
11000000001111000000L00010000011
11111111111111111111111110000011
11111111111111111111100000000001
1L000000000000000000000000000001
1L11111110000L000000000000000001
1L00000000011L110000100100111101
1L00000110011L110000100100111101
1L00000111011L110000000100111101
1L00010000011L11000000E110111101
1L11010000001L110110011100000001
1111111000000L000110011111111101
11111111111111111111111111111111
11111111111111111111111111111111
