11111111111111111111111111111111
11111111111111111111111101111101
10000000001000000000011100010001
1000100000000L000000000000000001
1111111000011L110000100000000001
1111100001111L110000100000000001
1011000011111L110000000000000001
1000000000011L110000000001100101
1000011000001L110110000001D00101
1010000000000L000110001111111101
11100000011111111111111111111111
10000000000111111111111111111111
10000000000000000000011111111111
10000000000011100111011111111111
11100000000011111100011111111111
111L0000000011111000011111011111
111L1111110001000000011000001111
100L0000010010000000001000001111
110L1111001010110000000000001111
110L0000001000100000100000000111
11111111111111100000111111111111
10000000000000000000011111111111
10000000000000000000000000000001
10000000000000000000000000000001
10010011110110000000000000000001
1001001111011L000000000000000001
1001001111011L111111000000000001
10E1101111000L000001000000000001
1111000000010L111100100000000001
1111111111010L000000111110011111
11111111111111111111111111111111
11111111111111111111111111111111
