11111111111111111111111111111111
11111111111111111111111111111111
10000000001111000000001001100L01
100010000001100000000010L0011L11
1111111000011000LD111011L1111L11
1111100001100000L1111111L1111L11
1011000011100000L111111100011L11
1000000000001100L001111011000L11
10000110000111111111111011011L11
10100000000000111000111000011111
11100000011111111111111111111111
11100000000111111111111111111111
11000000000100000000011111111111
11100000111000000000011111111111
10000000000011100111011111111111
100000000L0001110110011111011111
101111111L0000000000011000001111
101000111L0000000000001000001111
111000110L0000000110000000001111
11000000001011100111000000000111
11111111111110000001111111111111
11111111111111000001111111111111
10000000001001100001000000000001
10001000000000110000000000000001
11111110001010000111000000000001
11111000011011111111000000000001
10110000111001100000000000000001
10000010000000000000000000000001
10000010000000110010000000000001
1011111100000011E110011110011111
11111111111111111111111111111111
11111111111111111111111111111111
