11111111111111111111111111111111
11111111111111111111100000000001
10000000L00100000000000000011001
11011111L01000000000010001L01001
11000000L01011100111000000L00001
11001110L00001110110000000L11001
11000000L01000000000001110L11001
10000000L11000000000001010L11001
1000000D011000000110000000011111
11111111000011100111000000011011
11111111111110000001111111111111
11111111111110000000011111111111
10000000001100000000011111111111
10001000000110000011111111111111
11111110000000000000011111111111
1111100001100000000L011111011111
1011000011101111111L011000001111
1000000000001000111L001000001111
1000011000011000110L000000001111
10100000000100000000100000000111
11100000011111111111111111111111
11000000001111000001111111111111
10000000001111000000100000000001
10011111000110000000000000000001
1000000L000000011111000000000001
1000000L111000001110000000000001
1110000L111010000000000000000001
1111000L000010E00110000000000001
10000001000111101100000000000001
10111011100111100001011110011111
11111111111111111111111111111111
11111111111111111111111111111111
