11111111111111111111111111111111
11111111111111111111100000000001
10000000001111000000000000011001
10001000000110000000010001L01001
1111111000011000LD11100000L00001
1111100001100000L111100000L11001
1011000011100000L111101110L11001
1000000000001100L001101010L11001
10000110000111111111100000011111
10100000000000111000100000011011
11100000011111111111111111111111
11000000001111111111111111111111
10000000001100000000011111111111
10011111000000000000011111111111
1000000L000011100111011111111111
1000000L111001110110011111011111
1110000L111000000000011000001111
1111000L000000000000001000001111
10000001000000000110000000001111
10111011100011100111000000000111
11111111111110000001111111111111
10000001111000000001111111111111
10111100111011111110100000000001
10000000000000100000000000000001
10001111100000000000000000000001
10000000000000000000000000000001
11110000100011001110000000000001
11111001100000000000000000000001
10010011100000110110000000000001
1000000000000010E110011110011111
11111111111111111111111111111111
11111111111111111111111111111111
