11111111111111111111111111111111
11111111111000000111111111111111
110000000L000110001110L010000001
100000001L1000000000L1L110000001
10001D001L0000000011L1L000000001
100111111L0011110011L0L000000001
100111111L0000000011L0L000000001
101111111L0000000011L0L000010001
111111100L0000011111L11100011111
11111110000111000000L10000000011
11111111111111111111111100000111
11111111111000000111110000000011
11000000000011110011101100000011
10000000000000000000001100L00001
10111001110000111110001111L00001
10011101100000000000000000L00011
10000000000111000010000111L00011
10000000000111100110000000L00001
10000001100001001110000000L11101
10111001110000000000000000L10001
11100000011111111111111111111111
10000000000000000111111111111111
10000000000011110011100000000001
10000000000000000000000L00000001
10010011110000111110011L11000011
10010011110000000000011L11000011
10010011110111000010011L11000001
10E11011110111100110011L11000001
11110000000001001110001L11011001
11111111110000000000000L00011001
11111111111111111111111111111111
11111111111111111111111111111111
