11111111111111111111111111111111
11111111111111011111011111111111
1100000000011100010000000000L001
1000000000000000000001011111L011
1011100111000000000001000000L011
1001110110000000000001001110L001
1000000000000000000001000000L011
1000000000000001100100000000L011
1000000110000001D001000000001111
10111001110011111111011111111111
11100000011111111111111111111111
11000000001111111111111111111111
10000000000000000000111111111111
10001000000000100000011111111111
10000000000111111000011111111111
10111000011111100001111111011111
10110000011011000011111000001111
10000000000000000000001000001111
10000110000000011000000000001111
10000000100010000000000000000111
11111111111110000001111111111111
11111111111000000000011111111111
100000000000000000000L0000000001
100000000000000000000L1111111001
100000000000010011110L0000000001
100000000000010011110L0000011001
100000000000010011110L0000011101
100000000000E11011110L0001000001
100000000001110000000L1101000001
11111001111111111111011111100001
11111111111111111111111111111111
11111111111111111111111111111111
