11111111111111111111111111111111
11111111111111111111111111111111
11110000000000000000000000000001
1110000000000L000000011101111111
111000LD11111L110000110101111111
100000L111111L110000100000001111
100000L111111L110000000000000111
101100L001111L110000000000000001
1111111111101L110110001100000001
1000111000100L000110011000000111
11111111111111111111111111000111
11111111111111111111101111000011
10000000000000000000000010000111
1011100111000L000000000000000001
1011111100011L11000010L000000001
1011111000011L11000010L111110001
1001000000011L11000000L000010001
1010000000011L11000000L011011001
1010110000001L11011000L111001101
1000100000100L000110011111111101
11111000001111111111110001111111
11110000011111000011111111111111
100110000101100000010L0000000001
100011000000100000000L1111111001
1010000111000L0000L00L0000000001
1011111111000L1111L00L0000011001
1001100000000L0000L00L0000011101
1000000000000L1111L01L0001000001
1000110010000L1111L01L1101000001
100011E110010L1110L0011111100001
11111111111111111111111111111111
11111111111111111111111111111111
