11111111111111111111111111111111
11111111111111111111111111111111
1000000000010000000L011111111111
1011100111000000001L111111111111
101111110000001D001L011111111111
1011111000000111111L011111011111
1001000000000111111L011000001111
1010000000001111111L001000001111
1010110000011111100L000000001111
10001000001111111000000000000111
11111000001111111111111111111111
10111100001111000011111111111111
10001000011110000001000000000001
10000000000010000000011101111111
10L0000000000L0000L0010101111111
10L1111100000L1111L0000000001111
10L0000100000L0000L0000000000111
10L0110110000L1111L0100000000001
10L1110011000L1111L0101100000001
1111111111010L1110L0011000000111
11000111111111111111111111000111
11111111111000000111111100001111
1000000000001111001110000000L001
1000000000000000000001011111L011
1000000000000011111001000000L011
1000000000000000000001001110L001
1000000000011100001001000000L011
1000000000011110011000000000L111
10000000000001001110000E00000111
11111001111000000000011111110001
11111111111111111111111111111111
11111111111111111111111111111111
