11111111111111111111111111111111
11111111111111000000011111111111
11000001101111001000000000000011
11000001101100011110000010000001
11110001101100000000011111100001
11000001111100000101111110000111
1100000011100000L10D101100001111
1000000000011111L111100000000001
1000000000000011L111100001100001
1000111100100000L001101000000001
11111111111111111111111000000111
11111111111111111111100000000001
11111111111100000000000000000001
11111111111000000000000000000001
11111111111011100111011000000001
11111011111001110110011L00000001
11110000011000000000011L11111101
11110000010000000000000L00000101
11110000000000000110010L11110011
11100000000011100111010L00000011
11111111111110000001111111111111
11111111111000000001100000011111
10000000000011111110100110001111
100000000000001000000000000000L1
100000000000000000000000000011L1
100000000000000000000011110011L1
100000000000110011100000000011L1
100000000000000000000000000011L1
100000000000001101100000011111L1
1111100111100010E1100111000000L1
11111111111111111111111111111111
11111111111111111111111111111111
