11111111111111111111111111111111
11111111111111111111111111111111
1000000000110000000L000000000001
1000100000000000001L100000000001
111111100000001D001L000000000001
1111100001100111111L000000000001
1011000011100111111L000000000001
1000000000001111111L000000000001
1000011000011111100L000000000001
10100000000111111000011110011111
11100000011111111111111111111111
11100000000111111111111111111111
1100000000000000000010L010000001
1110000011100010000001L110000001
1000000000011111100011L000000001
100000000L011110000110L000000001
101111111L001100001110L000000001
101000111L000000100000L000010001
111000110L0000001000011100011111
11000000001011111100010000000011
11111111111111111111111100000111
10000001111000000111100000000111
10111100111001100011101111111011
10000000000000000000L00010000001
10001111100000000011L00000000001
10000000000011110011L00000000001
11110000100000000011L01100111001
11111001100000000011L00000000001
10010011100000011111L00011011001
10000000000111000000L00010E11001
11111111111111111111111111111111
11111111111111111111111111111111
