11111111111111111111111111111111
11111111111111111111111111111111
10000000001000000000011100000001
1000100000000L000000011000000001
1111111000011L110000111000LD1111
1111100001111L110000100000L11111
1011000011111L110000000000L11111
1000000000011L110000001100L00111
1000011000001L110110011111111111
1010000000000L000110000011100011
11100000011111111111111111111111
11100000000111111111111111111111
11000000000L00000000000000000011
11100000111L11111110000010000001
10000000000L00000000011111100001
100000000L0L00000110011110000111
101111111L0L00000111001100001111
101000111L0L00010000000000000001
111000110L0L11010000000001100001
11000000001111111000001000000001
11111111111111111111111000000111
10000001111000000001110000000011
10111100111011111110100000000011
10000000000000100000000111110001
100011111000000000000000000L0001
100000000000000000000000000L1111
111100001000110011100110000L1111
111110011000000000000111000L0001
10010011100000110110000000010001
1000000000000010E110001110111001
11111111111111111111111111111111
11111111111111111111111111111111
