11111111111111111111111111111111
11111111111111111111111111111111
10L0100000010000000L011111111111
11L1100000000000001L111111111111
11L000000000001D001L011111111111
10L0000000000111111L011111011111
10L0000000000111111L011000001111
10L0000100001111111L001000001111
1111000111111111100L000000001111
11000000001111111000000000000111
11110000011111111111111111111111
11000000001111111111111111111111
1011000000100000000010L010000001
101100L000000010000001L110000001
101111L000011111100011L000000001
100000L000111110000110L000000001
100111L000101100001110L000000001
100000L000000000100000L000010001
100000L1110000001000011100011111
100000L1000011111100010000000011
11111111111111111111111100000111
11111111111111000001101111000011
10000000000001100001000010000111
10000000000000110000000000000001
1000000000001000011100L000000001
1000000000001111111100L111110001
1000000000000110000000L000010001
1000000000000000000000L011011001
1000000000000011001000L111001101
1111100111100011E110011111111101
11111111111111111111110001111111
11111111111111111111111111111111
