11111111111111111111111111111111
11111111111111111111111111111111
1000000000110000000L011111111111
1000100000000000001L111111111111
111111100000001D001L011111111111
1111100001100111111L011111011111
1011000011100111111L011000001111
1000000000001111111L001000001111
1000011000011111100L000000001111
10100000000111111000000000000111
11100000011111111111111111111111
11000000001111111111111111111111
10000000000L00000000010000000001
10001000000L11111110000000000001
10000000000L00000000001110011101
10111000011L00000110000111011001
10110000011L00000111000000000001
10000000000L00010000000000000001
10000110000L11010000000000011001
10000000100111111000001110011101
11111111111111111111111000000111
11111111111111111111111100000111
10000000000000000000111100000011
10000000000000100000011000000001
10000000000111111000100001111101
10000000000111100001100000111001
10000000000011000011101000000001
100000000000000010000010E0011001
10000000000000001000011110110001
11111001111011111100011110000101
11111111111111111111111111111111
11111111111111111111111111111111
