11111111111111111111111111111111
11111111111111011111011111111111
10000000000111000100010000000001
10000000000000000000000000000001
10000000000000000000001110011101
10000000000000000000000111011001
10000000000000000000000000000001
10000000000000011001000000000001
1000000000000001D001000000011001
11111001111011111111001110011101
11111111111111111111111000000111
11111111111111111111110000000011
10000000000000000000100000000001
10111001110000100000000010000001
10111111000111111000100000000001
10111110000111100001101110000111
10010000000011000011101100000111
10100000000000001000000000000001
10101100000000001000000001100001
10001000001011111100000000001001
11111000001111111111111111111111
10111100001000000000011100001111
10001000011000000000011000000101
10000000000000000000001000000001
10L00000000001001111000L0000L001
10L11111000001001111000L1111L001
10L00001000001001111000L0000L001
10L011011000E1101111000L1111L011
10L11100110111000000000L1111L011
11111111110111111111010L1110L001
11000111111111111111111111111111
11111111111111111111111111111111
