11111111111111111111111111111111
11111111111111111111111111111111
11110000000L00000000010000000001
11100000000L11111110000000000001
111000LD111L00000000001110011101
100000L1111L00000110000111011001
100000L1111L00000111000000000001
101100L0011L00010000000000000001
11111111111L11010000000000011001
10001110001111111000001110011101
11111111111111111111111000000111
11111111111111111111111000000001
10000000000000000000110000000001
10111001110000100000011000001111
10111111000111111000100000000001
10111110000111100001100000000L01
10010000000011000011101111111L01
10100000000000001000001000111L01
10101100000000001000011000110L01
10001000001011111100010000000011
11111000001111111111111111111111
11000000001111000001111111111111
10000000000001100001000000000001
10001000000000110000000L00000001
10000000000010000111011L11000011
10111000011011111111011L11000011
10110000011001100000011L11000001
10000000000000000000011L11000001
10000110000000110010001L11011001
1000000010000011E110000L00011001
11111111111111111111111111111111
11111111111111111111111111111111
