11111111111111111111111111111111
11111111111111011111011111111111
1000000000011100010000L010000001
1000000000000000000001L110000001
1000000000000000000001L000000001
1000000000000000000000L000000001
1000000000000000000000L000000001
1000000000000001100100L000010001
1000000000000001D001011100011111
11111001111011111111010000000011
11111111111111111111111100000111
11111111111000000111101111000011
10L01000000011110011100010000111
11L11000000000000000000000000001
11L0000000000011111000L000000001
10L0000000000000000000L111110001
10L0000000011100001000L000010001
10L0000100011110011000L011011001
1111000111100100111000L111001101
11000000001000000000011111111101
11110000011111111111110001111111
10000000000111111111111111111111
10000000000L00000000011111111111
10000000000L11111110011111111111
10010011110L00000000011111111111
10010011110L00000110011111011111
10010011110L00000111011000001111
10E11011110L00010000001000001111
11110000000L11010000000000001111
11111111110111111000000000000111
11111111111111111111111111111111
11111111111111111111111111111111
