11111111111111111111111111111111
11111111111111111111111111111111
10000000L00000000000100011100001
11011111L01000100000000000001101
11000000L01111111000000000011111
11001110L00111100001100000000001
11000000L01011000011100000000001
10000000L01000000000000001100101
10000000111000011000000001D00101
11111111111010000000011111111111
11111111111110000001111111111111
11111111111011110000111111111111
11111111111000100001100000000001
11111111111000000000001110011101
111111111110L0000000001111110001
111110111110L1111100001111100001
111100000110L0000100000100000001
111100000100L0110110001000000001
111100000000L1110011001011000001
11100000000111111111000010000011
11111111111100011111111110000011
11111111111111111111111100000111
10000000000000000000000110000101
1000000000000L000000000011000001
1000000000011L110000101000011101
1000000000011L110000101111111101
1000000000011L110000000110000001
1000000000011L110000000000000001
1000000000001L110110000011001001
1111100111100L000110000011E11001
11111111111111111111111111111111
11111111111111111111111111111111
