11111111111111111111111111111111
11110111110000000111111111111111
11110001000001100011110000000001
10000000000000000000L00000000001
10000000000000000011L01110011101
10000000000011110011L00111011001
10000000000000000011L00000000001
10000110010000000011L00000000001
100001D0010000011111L00000011001
10111111110111000000L01110011101
11111111111111111111111000000111
11111111111111111111110000000011
10000000000000000000000000000001
10000000000011100111000010000001
10000000000011111100000000000001
10000000000011111000001110000111
10000000000001000000001100000111
10000000000010000000000000000001
10000000000010110000000001100001
11111001111000100000100000001001
11111111111111100000111111111111
11110000111000000000011111111111
10000000L00000000000011111111111
11011111L01000000000011111111111
11000000L01110000000011111111111
11001110L0011L000000011111011111
11000000L0111L111111011000001111
10000000L1100L000001001000001111
100E000001110L111100100000001111
1111111100010L000000100000000111
11111111111111111111111111111111
11111111111111111111111111111111
