11111111111111111111111111111111
10000000000111111111111111111111
1000000110000000000000000000L001
110001L010011101111111011111L011
100000L000010101111111000000L011
100000L110000000001111001110L001
101110L110000000000111000000L011
101010L110000000000000000000L111
100000011110110000000000000D0111
10000001101110000001111111110001
11111111111111110001111111111111
11111111111000000000011111111111
11111111111000000000000000000001
11111111111000000000001110011101
11111111111110000000001111110001
1111101111111L000000001111100001
1111000001111L111111000100000001
1111000001000L000001001000000001
1111000000010L111100101011000001
1110000000010L000000100010000011
11111111111111111111111110000011
11111111111111000001100000000001
10000000000001100001000000000001
10000000000000110000000000000001
10000000000010000111011000000001
10000000000011111111011L00000001
10000000000001100000011L11111101
10000000000000000000000L00000101
10000000000000110010010L11110011
1111100111100011E110010L00000011
11111111111111111111111111111111
11111111111111111111111111111111
