11111111111111111111111111111111
11111111111111000000011111111111
10000000000111001000010000000001
10000000000100011110000000000001
10000000000100000000001110011101
10000000000100000101100111011001
1000000000000000L10D100000000001
1000000000011111L111100000000001
1000000000000011L111100000011001
1111100111100000L001101110011101
11111111111111111111111000000111
11111111111111111111100000000001
11000000000L00000000000000000001
10000000000L11111110000000000001
10111001110L00000000011000000001
10011101100L00000110011L00000001
10000000000L00000111011L11111101
10000000000L00010000000L00000101
10000001100L11010000010L11110011
10111001110111111000010L00000011
11100000011111111111111111111111
10000000000111000001100000011111
10000000000001100001001111001111
10000000000000110000000000000001
11100000000010000111000011111001
111L0000000011111111000000000001
111L1111110001100000011100001001
100L0000010000000000011110011001
110L1111001000110010000100111001
110L000000100011E110000000000001
11111111111111111111111111111111
11111111111111111111111111111111
