11111111111111111111111111111111
11110000000111111111100000000001
11110010000000000000100000011001
11000111100000100000010001L01001
11000000000111111000000000L00001
11000001011111100001100000L11001
100000L10D1011000011101110L11001
111111L1111000000000001010L11001
100011L1111000011000000000011111
100000L0011010000000000000011011
11111111111110000001111111111111
11111111111100000000111111111111
10L01000000000000000111111111111
11L11000000001111100011111111111
11L00000000000000L00011111111111
10L00000000000000L11111111011111
10L00000000110000L11111000001111
10L00001000111000L00001000001111
11110001111000000100000000001111
11000000001011101110000000000111
11110000011111111111111111111111
11110000011111111111111111111111
11110000001000000000100000000001
11100000000000100000000000000001
10000111110111111000100000000001
10000011100111100001100000000001
10100000000011000011100000000001
1010E001100000001000000000000001
11111011000000001000000000000001
11111000010011111100011110011111
11111111111111111111111111111111
11111111111111111111111111111111
