11111111111111111111111111111111
11111111111111111111111111111111
10000000000000000000100011100001
10111001110000100000000000001101
10111111000111111000100000011111
10111110000111100001100000000001
10010000000011000011100000000001
10100000000000001000000001100101
10101100000000001000000001D00101
10001000001011111100011111111111
11111000001111111111111111111111
10111100001111111111111111111111
10001000011L00000000000000000011
10000000000L11111110000010000001
10L00000000L00000000011111100001
10L11111000L00000110011110000111
10L00001000L00000111001100001111
10L01101100L00010000000000000001
10L11100110L11010000000001100001
11111111110111111000001000000001
11000111111111111111111000000111
10000001111000000001110000000011
10111100111011111110101100000011
10000000000000100000001100L00001
10001111100000000000001111L00001
10000000000000000000000000L00011
11110000100011001110000111L00011
11111001100000000000000000L00001
10010011100000110110000000L11101
1000000000000010E110000000L10001
11111111111111111111111111111111
11111111111111111111111111111111
