11111111111111111111111111111111
11111111111111111111111111111111
10000000000111000000011111111111
11110111111110000000011111111111
1101011111111000LD11111111111111
1000000011100000L111111111011111
1000000001100000L111111000001111
1000000000001100L001101000001111
10110000000111111111100000001111
11100000011000111000100000000111
11111100011111111111111111111111
10000000000111111111111111111111
10000000000000000000000000000011
1000000000000L000000000010000001
1110000000011L110000111111100001
111L000000011L110000111110000111
111L111111011L110000001100001111
100L000001011L110000000000000001
110L111100101L110110000001100001
110L000000100L000110001000000001
11111111111111111111111000000111
11111111111000000111100110011101
10000000000001100011100000001001
10000000000000000000L11111101111
10000000000000000011L01000000001
10000000000011110011L00000111111
10000000000000000011L00000000001
10000000000000000011L00001000001
10000000000000011111L00011000001
11111001111111000000L0011111E011
11111111111111111111111111111111
11111111111111111111111111111111
