11111111111111111111111111111111
11111111111111111111111101111101
10000000001000000000011100010001
1000100000000L000000000000000001
1111111000011L110000100000000001
1111100001111L110000100000000001
1011000011111L110000000000000001
1000000000011L110000000001100101
1000011000001L110110000001D00101
1010000000000L000110001111111101
11100000011111111111111111111111
10000000000111111111111111111111
10000000000000000000111111111111
10000000000000100000011111111111
11100000000111111000011111111111
111L0000000111100001111111011111
111L1111110011000011111000001111
100L0000010000000000001000001111
110L1111001000011000000000001111
110L0000001010000000000000000111
11111111111110000001111111111111
10000000011011110000111111111111
10111111101000100001100000000001
10001000000000000000000000000001
100000000000L0000000000000000001
100000000000L1111100000000000001
101100111000L0000100000000000001
100000000000L0110110000000000001
100011011000L1110011000000000001
100010E1100111111111011110011111
11111111111100011111111111111111
11111111111111111111111111111111
