11111111111111111111111111111111
11111111111111111111111111111111
1111111111100000000010000000L001
1111111111100010000001011111L011
1111111111111111100001000000L011
1111101111111110000111001110L001
1111000001101100001111000000L011
1111000001000000000000000000L111
111100000000000110000000000D0111
11100000000010000000011111110001
11111111111110000001111111111111
11111111111100000000111111111111
10000000000000000000000000000011
10000000000000100000000010000001
10000000000000000000011111100001
10000000000011100001111110000111
10000000000011000001101100001111
10000000000000000000000000000001
10000000000000011000000001100001
11111001111000000010001000000001
11111111111111111111111000000111
11110000011000000111100000000001
10011000010011110011100000000001
10001100000000000000000000000001
10100001110000111110011000000001
10111111110000000000011L00000001
10011000000111000010011L11111101
10000000000111100110000L00000101
10001100100001001110010L11110011
100011E1100000000000010L00000011
11111111111111111111111111111111
11111111111111111111111111111111
