11111111111111111111111111111111
11111111111000000111111111111111
10001110000001100011100000000001
10000000110000000000L01110011101
10000001111000000011L01111110001
10000000000011110011L01111100001
10000000000000000011L00100000001
10000110010000000011L01000000001
100001D0010000011111L01011000001
11111111111111000000L00010000011
11111111111111111111111110000011
11111111111111111111101111000011
11111111111000000000100010000111
11111111111000100000000000000001
1111111111111111100000L000000001
1111101111111110000110L111110001
1111000001101100001110L000010001
1111000001000000000000L011011001
1111000000000001100000L111001101
11100000000010000000011111111101
11111111111110000001110001111111
11111111111001100111000000011111
10000000000000000010001111001111
10000000000111111011100000000001
10000000000010000000000011111001
10000000000000001111100000000001
10000000000000000000011100001001
10000000000000010000011110011001
10000000000000110000000100111001
111110011110011111E0100000000001
11111111111111111111111111111111
11111111111111111111111111111111
