11111111111111111111111111111111
11111111111111111111111101111101
10000000000000000000111100010001
10111001110000100000000000000001
10111111000111111000100000000001
10111110000111100001100000000001
10010000000011000011100000000001
10100000000000001000000001100101
10101100000000001000000001D00101
10001000001011111100001111111101
11111000001111111111111111111111
11000000001111111111111111111111
10110000001000000000100000000011
101100L0000000100000000010000001
101111L0000111111000111111100001
100000L0001111100001111110000111
100111L0001011000011101100001111
100000L0000000001000000000000001
100000L1110000001000000001100001
100000L1000011111100001000000001
11111111111111111111111000000111
10000000000111111111110000000011
10000000000L00000000000000000011
10000000000L11111110000111110001
10010011110L000000000000000L0001
10010011110L000001100000000L1111
10010011110L000001110110000L1111
10E11011110L000100000111000L0001
11110000000L11010000000000010001
11111111110111111000001110111001
11111111111111111111111111111111
11111111111111111111111111111111
