11111111111111111111111111111111
11111111111111111111111111111111
110000000L0000000000100000000011
100000001L1000100000000010000001
10001D001L0111111000111111100001
100111111L0111100001111110000111
100111111L0011000011101100001111
101111111L0000001000000000000001
111111100L0000001000000001100001
11111110000011111100001000000001
11111111111111111111111000000111
11111111111111111111110000000011
10L01000000000000000001100000011
11L1100000000L000000001100L00001
11L0000000011L110000101111L00001
10L0000000011L110000100000L00011
10L0000000011L110000000111L00011
10L0000100011L110000000000L00001
1111000111101L110110000000L11101
1100000000100L000110000000L10001
11110000011111111111111111111111
10000000000111111111111111111111
10000000000L00000000000000000001
10000000000L11111110000000000001
10010011110L00000000000000000001
10010011110L00000110000000000001
10010011110L00000111000000000001
10E11011110L00010000000000000001
11110000000L11010000000000000001
11111111110111111000011110011111
11111111111111111111111111111111
11111111111111111111111111111111
