11111111111111111111111111111111
11111111111111111111100000000001
10000000001000111000000000011001
10001000000000000011010001L01001
11111110000000000111100000L00001
11111000011000000000000000L11001
10110000111000000000001110L11001
10000000000000011001001010L11001
1000011000000001D001000000011111
10100000000111111111100000011011
11100000011111111111111111111111
11100000000111111111111111111111
11000000000000000000011111111111
11100000111111011111111111111111
10000000000101011111111111111111
100000000L0000000011111111011111
101111111L0000000001111000001111
101000111L0000000000001000001111
111000110L0011000000000000001111
11000000001110000001100000000111
11111111111111110001111111111111
11111111111111000001111111111111
10000000001111000000100000000001
10001000000110000000000000000001
11111110001000011111000000000001
11111000011000001110000000000001
10110000111010000000000000000001
10000010000010E00110000000000001
10000010000111101100000000000001
10111111000111100001011110011111
11111111111111111111111111111111
11111111111111111111111111111111
