11111111111111111111111111111111
11111111111111111111111111111111
10000000L00000000000000000000011
11011111L0100L000000000010000001
11000000L0111L110000111111100001
11001110L0011L110000111110000111
11000000L0111L110000001100001111
10000000L1111L110000000000000001
1000000D01101L110110000001100001
1111111100000L000110001000000001
11111111111111111111111000000111
11111111111111111111110000000011
11111111111000000000001100000011
11111111111011100111001100L00001
11111111111011111100001111L00001
11111011111011111000000000L00011
11110000011001000000000111L00011
11110000010010000000000000L00001
11110000000010110000000000L11101
11100000000000100000100000L10001
11111111111111100000111111111111
11111111111100000000100000000111
10000000000000000000101111111011
10000000000001111100000010000001
10000000000000000L00000000000001
10000000000000000L11100000000001
10000000000110000L11101100111001
10000000000111000L00000000000001
10000000000000000100000011011001
11111001111011101110000010E11001
11111111111111111111111111111111
11111111111111111111111111111111
