11111111111111111111111111111111
11110111110111111111111111111111
11110001000000000000100000000001
10000000000000100000011101111111
10000000000111111000110101111111
10000000000111100001100000001111
10000000000011000011100000000111
10000110010000001000000000000001
100001D0010000001000001100000001
10111111110011111100011000000111
11111111111111111111111111000111
11111111111111000011110000000011
10000000000110000001000000000011
10111001110010000000000111110001
1011111100000L0000L00000000L0001
1011111000000L1111L00000000L1111
1001000000000L0000L00110000L1111
1010000000000L1111L01111000L0001
1010110000000L1111L0100000010001
1000100000110L1110L0001110111001
11111000001111111111111111111111
11110000011111000011111111111111
11110000001110000001000000000011
11100000000010000000000010000001
1000011111000L0000L0011111100011
1000001110000L1111L0011110000111
1010000000000L0000L0001100001111
1010E00110000L1111L0100000100001
1111101100000L1111L0100000100001
1111100001010L1110L0001111110001
11111111111111111111111111111111
11111111111111111111111111111111
