11111111111111111111111111111111
11111111111111111111111111111111
10000000000111000000000000000001
10000000000110000000001110011101
1000000000011000LD11101111110001
1000000000000000L111101111100001
1000000000000000L111100100000001
1000000000001100L001101000000001
10000000000111111111101011000001
11111001111000111000100010000011
11111111111111111111111110000011
11111111111111111111100000000001
11000000000000000000100000000001
10000000000000100000000000000001
10111001110111111000111000000001
10011101100111100001111L00000001
10000000000011000011111L11111101
10000000000000001000000L00000101
10000001100000001000010L11110011
10111001110011111100010L00000011
11100000011111111111111111111111
10011001110111111111111111111111
10000000100000000000111111111111
11111110111000100000011111111111
10100000000111111000111111111111
10000011111111100001111111011111
10000000000011000011111000001111
10000100000000001000001000001111
10001100000000001000000000001111
10011111E01011111100000000000111
11111111111111111111111111111111
11111111111111111111111111111111
