11111111111111111111111111111111
11111111111111111111111111111111
10001110000100000000011111111111
10000000110000000000011111111111
10000001111011100111011111111111
10000000000001110110011111011111
10000000000000000000011000001111
10000110010000000000001000001111
100001D0010000000110000000001111
11111111111011100111000000000111
11111111111110000001111111111111
11111111111100000000111111111111
10000000000000000000100000000001
10000000000001111100011101111111
10000000000000000L00010101111111
10000000000000000L11100000001111
10000000000110000L11100000000111
10000000000111000L00000000000001
10000000000000000100001100000001
11111001111011101110011000000111
11111111111111111111111111000111
11111111111111000001100000000001
10000000001001100001000000000001
10001000000000110000000000000001
11111110001010000111011000000001
11111000011011111111011L00000001
10110000111001100000011L11111101
10000010000000000000000L00000101
10000010000000110010010L11110011
1011111100000011E110010L00000011
11111111111111111111111111111111
11111111111111111111111111111111
