11111111111111111111111111111111
11111111111111111111111111111111
10000000000111000000000000000001
10111001110110000000000000000001
1011111100011000LD11100000000001
1011111000000000L111100000000001
1001000000000000L111100000000001
1010000000001100L001100000000001
10101100000111111111100000000001
10001000001000111000111110011111
11111000001111111111111111111111
10111100001111000011111111111111
10001000011110000001000000000011
10000000000010000000000010000001
10L0000000000L0000L0011111100001
10L1111100000L1111L0011110000111
10L0000100000L0000L0001100001111
10L0110110000L1111L0100000000001
10L1110011000L1111L0100001100001
1111111111010L1110L0001000000001
11000111111111111111111000000111
11110000111000000001101111000011
11100000010011111110100010000111
10100000000000100000000000000001
100L0000L0000000000000L000000001
100L1111L0000000000000L111110001
100L0000L0001100111000L000010001
100L1111L0100000000000L011011001
100L1111L0100011011000L111001101
110L1110L0000010E110011111111101
11111111111111111111110001111111
11111111111111111111111111111111
