11111111111111111111111111111111
11111111111111111111111111111111
1100000000010000000L000000000001
1000000000000000001L111000000111
101110011100001D001L011101010111
1001110110000111111L011111111111
1000000000000111111L011010100111
1000000000001111111L000000000101
1000000110011111100L000010000111
10111001110111111000000111110001
11100000011111111111111111111111
11000000001111111111111111111111
100000000000L0100000011111111111
100010000001L1100000011111111111
100000000001L0000000011111111111
101110000110L0000000011111011111
101100000110L0000000011000001111
100000000000L0000100001000001111
10000110000111000111100000001111
10000000100100000000100000000111
11111111111111000001111111111111
11111111111100000000100000000111
10000000000000000000101111111011
10000000000001111100000010000001
10000000000000000L00000000000001
10000000000000000L11100000000001
10000000000110000L11101100111001
10000000000111000L00000000000001
10000000000000000100000011011001
11111001111011101110000010E11001
11111111111111111111111111111111
11111111111111111111111111111111
