11111111111111111111111111111111
11111111111111111111111111111111
10000000000000111000011111111111
10111001110000000011011111111111
10111111000000000111111111111111
10111110000000000000011111011111
10010000000000000000011000001111
10100000000000011001001000001111
1010110000000001D001000000001111
10001000001111111111100000000111
11111000001111111111111111111111
10111100001111111111111111111111
10001000011L0000000000L010000001
10000000000L1111111001L110000001
10L00000000L0000000001L000000001
10L11111000L0000011000L000000001
10L00001000L0000011100L000000001
10L01101100L0001000000L000010001
10L11100110L11010000011100011111
11111111110111111000010000000011
11000111111111111111111100000111
11111111111000000111111100000111
10000000000001100011111100000011
10000000000000000000L11000000001
10000000000000000011L00001111101
10000000000011110011L00000111001
10000000000000000011L01000000001
10000000000000000011L010E0011001
10000000000000011111L11110110001
11111001111111000000L11110000101
11111111111111111111111111111111
11111111111111111111111111111111
