11111111111111111111111111111111
11111111111111011111011111111111
10000000000111000100010000000001
10000000000000000000000000000001
10000000000000000000001110011101
10000000000000000000000111011001
10000000000000000000000000000001
10000000000000011001000000000001
1000000000000001D001000000011001
11111001111011111111001110011101
11111111111111111111111000000111
11111111111000000111101111000011
10000000001011110011100010000111
10001000000000000000000000000001
1111111000000011111000L000000001
1111100001100000000000L111110001
1011000011111100001000L000010001
1000000000011110011000L011011001
1000011000000100111000L111001101
10100000000000000000011111111101
11100000011111111111110001111111
11000000001111111111111100001111
10000000000L0000000000000000L001
10001000000L1111111001011111L011
10000000000L0000000001000000L011
10111000011L0000011001001110L001
10110000011L0000011101000000L011
10000000000L0001000000000000L111
10000110000L11010000000E00000111
10000000100111111000011111110001
11111111111111111111111111111111
11111111111111111111111111111111
