11111111111111111111111111111111
11111111111111011111011111111111
11111111111111000100000000000001
11111111111000000000001110011101
11111111111000000000001111110001
11111011111000000000001111100001
11110000011000000000000100000001
11110000010000011001001000000001
1111000000000001D001001011000001
11100000000011111111000010000011
11111111111111111111111110000011
11111111111111111111110000000011
10000000000000000000100000000001
10000000000000100000000010000001
10000000000111111000000000000001
10000000000111100001101110000111
10000000000011000011101100000111
10000000000000000000000000000001
10000000000000011000000001100001
11111001111010000000000000001001
11111111111110000001111111111111
10011001110011110000111111111111
10000000100000100001110000111111
11111110111000000000010000011011
101000000000L0000000010000001011
100000111110L1111100010000000011
100000000000L0000100010000000011
100001000000L0110110000000000001
100011000000L1110011000111010011
10011111E01111111111001111110111
11111111111100011111111111111111
11111111111111111111111111111111
