11111111111111111111111111111111
11111111111111111111111111111111
10000000000000000000110000000L01
10000000000000100000000000001L11
1000000000011111100000001D001L01
10000000000111100001100111111L01
10000000000011000011100111111L01
10000000000000000000001111111L01
10000000000000011000011111100L01
11111001111010000000011111100001
11111111111110000001111111111111
11111111111100000000100000000001
10000000001000000000000000011001
10001000000000100000010001L01001
11111110000000000000000000L00001
11111000011011100001100000L11001
10110000111011000001101110L11001
10000000000000000000001010L11001
10000110000000011000000000011111
10100000000000000010000000011011
11100000011111111111111111111111
10000000000111000011111111111111
100000000000000000L0011111111111
100000000001011111L0111111111111
111000000001000000L0111111111111
111L00000001001110L0011111011111
111L11111101000000L0111000001111
100L00000100000000L1101000001111
110L111100100E000001100000001111
110L0000001111111100000000000111
11111111111111111111111111111111
11111111111111111111111111111111
