11111111111111111111111111111111
11111111111111111111111111111111
11000011111000000000111100000001
11000001101000100000011000000001
11000000101111111000011000LD1111
11000000001111100001100000L11111
11000000001011000011100000L11111
10000000000000000000001100L00111
10011101001000011000011111111111
10111111011010000000000011100011
11111111111110000001111111111111
11111111111000000000011111111111
11111111111000000000000000000001
11111111111000000000011101111111
11111111111110000000010101111111
1111101111111L000000000000001111
1111000001111L111111000000000111
1111000001000L000001000000000001
1111000000010L111100101100000001
1110000000010L000000111000000111
11111111111111111111111111000111
11111111111111111111100110011101
10000000000000000000000000001001
1000000000000L000000011111101111
1000000000011L110000101000000001
1000000000011L110000100000111111
1000000000011L110000000000000001
1000000000011L110000000001000001
1000000000001L110110000011000001
1111100111100L00011000011111E011
11111111111111111111111111111111
11111111111111111111111111111111
