11111111111111111111111111111111
11111111111111000011111100000001
10L01000000110000001011100100001
11L11000000010000000010001111001
11L0000000000L0000L0010000000001
10L0000000000L1111L0010000010111
10L0000000000L0000L0000000L10D11
10L0000100000L1111L0111111L11111
1111000111100L1111L0100011L11111
1100000000110L1110L0000000L00111
11110000011111111111111111111111
11000000001111111111111111111111
10000000001000000000111111111111
10011111000000100000011111111111
1000000L000111111000011111111111
1000000L111111100001111111011111
1110000L111011000011111000001111
1111000L000000000000001000001111
10000001000000011000000000001111
10111011100010000000000000000111
11111111111110000001111111111111
11111111111011110000100110011101
10000000000000100001100000001001
10000000000000000000011111101111
100000000000L0000000001000000001
100000000000L1111100000000111111
100000000000L0000100000000000001
100000000000L0110110000001000001
100000000000L1110011000011000001
1111100111111111111100011111E011
11111111111100011111111111111111
11111111111111111111111111111111
