11111111111111111111111111111111
11111111111111000011111111111111
10001110000110000001000000000011
10000000110010000000000010000001
1000000111100L0000L0011111100001
1000000000000L1111L0011110000111
1000000000000L0000L0001100001111
1000011001000L1111L0100000000001
100001D001000L1111L0100001100001
1111111111110L1110L0001000000001
11111111111111111111111000000111
11111111111111111111111000000001
100000000000L0100000010000000001
100000000001L1100000011000001111
100000000001L0000000000000000001
100000000000L0000000000000000L01
100000000000L0000000001111111L01
100000000000L0000100001000111L01
10000000000111000111111000110L01
11111001111100000000110000000011
11111111111111000001111111111111
10000000011100000000111111111111
10111111101011000000111111111111
1000100000001100L000011111111111
1000000000001111L000011111111111
1000000000000000L000111111011111
1011001110000111L000111000001111
1000000000000000L000001000001111
1000110110000000L111000000001111
100010E110000000L100000000000111
11111111111111111111111111111111
11111111111111111111111111111111
