11111111111111111111111111111111
11110111110111111111111111111111
11110001000000000000011111111111
10000000000111011111111111111111
10000000000101011111111111111111
10000000000000000011111111011111
10000000000000000001111000001111
10000110010000000000001000001111
100001D0010011000000000000001111
10111111110110000001100000000111
11111111111111110001111111111111
11111111111100000000111111111111
10000000000000000000100000000011
10000000000001111100000010000001
10000000000000000L00011111100001
10000000000000000L11111110000111
10000000000110000L11101100001111
10000000000111000L00000000000001
10000000000000000100000001100001
11111001111011101110001000000001
11111111111111111111111000000111
11110000011000000111100000000001
10011000010001100011100000000001
10001100000000000000L00000000001
10100001110000000011L11000000001
10111111110011110011L11L00000001
10011000000000000011L11L11111101
10000000000000000011L00L00000101
10001100100000011111L10L11110011
100011E1100111000000L10L00000011
11111111111111111111111111111111
11111111111111111111111111111111
