11111111111111111111111111111111
11111111111000000111111101111101
10000000001011110011111100010001
10001000000000000000000000000001
11111110000000111110000000000001
11111000011000000000000000000001
10110000111111000010000000000001
10000000000111100110000001100101
10000110000001001110000001D00101
10100000000000000000001111111101
11100000011111111111111111111111
11000000001111111111111111111111
10000000000000000000111111111111
10001000000000100000011111111111
10000000000111111000011111111111
10111000011111100001111111011111
10110000011011000011111000001111
10000000000000000000001000001111
10000110000000011000000000001111
10000000100010000000000000000111
11111111111110000001111111111111
11111111111100000000100110011101
10000000000011000000100000001001
1000000000001100L000011111101111
1000000000001111L000001000000001
1000000000000000L000100000111111
1000000000000111L000100000000001
1000000000000000L000000001000001
1000000000000000L111000011000001
1111100111100000L10000011111E011
11111111111111111111111111111111
11111111111111111111111111111111
