11111111111111111111111111111111
11111111111000000111111111111111
10000000L00011110011100000000001
11011111L01000000000011101111111
11000000L01000111110010101111111
11001110L00000000000000000001111
11000000L01111000010000000000111
10000000L11111100110000000000001
1000000D011001001110001100000001
11111111000000000000011000000111
11111111111111111111111111000111
11111111111111111111110000000011
10000000001000000000100000000001
10001000000000100000000010000001
11111110000111111000100000000001
11111000011111100001101110000111
10110000111011000011101100000111
10000000000000001000000000000001
10000110000000001000000001100001
10100000000011111100000000001001
11100000011111111111111111111111
11100000000111111111111100000111
11000000000000000000011100000011
1110000011100L000000011000000001
1000000000011L110000100001111101
100000000L011L110000100000111001
101111111L011L110000001000000001
101000111L011L1100000010E0011001
111000110L001L110110011110110001
1100000000100L000110011110000101
11111111111111111111111111111111
11111111111111111111111111111111
