11111111111111111111111111111111
11111111111111111111111111111111
10000000000000000000110000000L01
11110111111000100000000000001L11
1101011111111111100010001D001L01
10000000111111100001100111111L01
10000000011011000011100111111L01
10000000000000001000001111111L01
10110000000000001000011111100L01
11100000011011111100011111100001
11111100011111111111111111111111
11000000001111111111111111111111
10000000001000000000011111111111
10011111000011100111011111111111
1000000L000011111100011111111111
1000000L111011111000011111011111
1110000L111001000000011000001111
1111000L000010000000001000001111
10000001000010110000000000001111
10111011100000100000100000000111
11111111111111100000111111111111
11111111111111000001111111111111
10000000000001100001000000000001
10000000000000110000000L00000001
10000000000010000111011L11000011
10000000000011111111011L11000011
10000000000001100000011L11000001
10000000000000000000011L11000001
10000000000000110010001L11011001
1111100111100011E110000L00011001
11111111111111111111111111111111
11111111111111111111111111111111
