11111111111111111111111111111111
11111111111000000111111101111101
10L01000000001100011111100010001
11L11000000000000000L00000000001
11L00000000000000011L00000000001
10L00000000011110011L00000000001
10L00000000000000011L00000000001
10L00001000000000011L00001100101
11110001111000011111L00001D00101
11000000001111000000L01111111101
11110000011111111111111111111111
11000000001111111111111111111111
10110000001000000000111111111111
101100L0000000100000011111111111
101111L0000111111000011111111111
100000L0001111100001111111011111
100111L0001011000011111000001111
100000L0000000000000001000001111
100000L1110000011000000000001111
100000L1000010000000000000000111
11111111111110000001111111111111
10000000000100000000111111111111
10000000000011000000100000000001
1000000000001100L000000000000001
1001001111001111L000000000000001
1001001111000000L000100000000001
1001001111000111L000100000000001
10E1101111000000L000000000000001
1111000000000000L111000000000001
1111111111000000L100011110011111
11111111111111111111111111111111
11111111111111111111111111111111
