11111111111111111111111111111111
11111111111111011111011111111111
10000000000111000100000000000001
11110111111000000000000000000001
11010111111000000000000000000001
10000000111000000000000000000001
10000000011000000000000000000001
10000000000000011001000000000001
1011000000000001D001000000000001
11100000011011111111011110011111
11111100011111111111111111111111
10000000000000000111111111111111
10000000000011110011100000000011
10000000000000000000000010000001
11100000000000111110011111100001
111L0000000000000000011110000111
111L1111110111000010001100001111
100L0000010111100110000000000001
110L1111001001001110000001100001
110L0000001000000000001000000001
11111111111111111111111000000111
10000001111000000111100110011101
10111100111001100011100000001001
10000000000000000000L11111101111
10001111100000000011L01000000001
10000000000011110011L00000111111
11110000100000000011L00000000001
11111001100000000011L00001000001
10010011100000011111L00011000001
10000000000111000000L0011111E011
11111111111111111111111111111111
11111111111111111111111111111111
