11111111111111111111111111111111
11110111110000000111111111111111
1111000100000110001110L010000001
10000000000000000000L1L110000001
10000000000000000011L1L000000001
10000000000011110011L0L000000001
10000000000000000011L0L000000001
10000110010000000011L0L000010001
100001D0010000011111L11100011111
10111111110111000000L10000000011
11111111111111111111111100000111
11111111111111111111110000000011
10L01000000L00000000000000000001
11L11000000L11111110000010000001
11L00000000L00000000000000000001
10L00000000L00000110001110000111
10L00000000L00000111001100000111
10L00001000L00010000000000000001
11110001111L11010000000001100001
11000000001111111000000000001001
11110000011111111111111111111111
11100000000111000001111111111111
11000000000001100001000000000001
11100000111000110000000L00000001
10000000000010000111011L11000011
100000000L0011111111011L11000011
101111111L0001100000011L11000001
101000111L0000000000011L11000001
111000110L0000110010001L11011001
1100000000100011E110000L00011001
11111111111111111111111111111111
11111111111111111111111111111111
