11111111111111111111111111111111
11111111111111111111111100000001
10000000000000000000111100100001
10000000000000100000010001111001
10000000000111111000010000000001
10000000000111100001110000010111
10000000000011000011100000L10D11
10000000000000000000011111L11111
10000000000000011000000011L11111
11111001111010000000000000L00111
11111111111110000001111111111111
11111111111100000000111111111111
10000000001000000000111111111111
10001000000001111100011111111111
11111110000000000L00011111111111
11111000011000000L11111111011111
10110000111110000L11111000001111
10000000000111000L00001000001111
10000110000000000100000000001111
10100000000011101110000000000111
11100000011111111111111111111111
11110000011000000111100000011111
11110000001011110011101111001111
11100000000000000000000000000001
10000111110000111110000011111001
10000011100000000000000000000001
10100000000111000010011100001001
1010E001100111100110011110011001
11111011000001001110000100111001
11111000010000000000000000000001
11111111111111111111111111111111
11111111111111111111111111111111
