11111111111111111111111111111111
11111111111111011111011111111111
11111111111111000100000000000001
11111111111000000000011101111111
11111111111000000000010101111111
11111011111000000000000000001111
11110000011000000000000000000111
11110000010000011001000000000001
1111000000000001D001001100000001
11100000000011111111011000000111
11111111111111111111111111000111
11111111111111111111101111000011
10000000000000000000000010000111
10000000000111011111100000000001
1000000000010101111110L000000001
1000000000000000001110L111110001
1000000000000000000110L000010001
1000000000000000000000L011011001
1000000000001100000000L111001101
11111001111110000001111111111101
11111111111111110001110001111111
10000001111000000001111111111111
10011000111011111110110000011011
1000000000L000100000010000011011
1000000011L000000000011100011011
1011110011L000000000010000011111
1000000011L011001110010000001111
1000000011L000000000000000000001
1000011111L000110110000000000001
1111000000L00010E110000011110011
11111111111111111111111111111111
11111111111111111111111111111111
