11111111111111111111111111111111
11111111111111111111111111111111
10000000001000111000000000000001
10001000000000000011000000000001
11111110000000000111100000000001
11111000011000000000000000000001
10110000111000000000000000000001
10000000000000011001000000000001
1000011000000001D001000000000001
10100000000111111111111110011111
11100000011111111111111111111111
11000000001000000111111111111111
10110000001001100011100000000011
101100L0000000000000L00010000001
101111L0000000000011L11111100001
100000L0001011110011L11110000111
100111L0001000000011L01100001111
100000L0000000000011L00000000001
100000L1110000011111L00001100001
100000L1000111000000L01000000001
11111111111111111111111000000111
10000001111111000011110000000011
100110001110000000L0000000000001
1000000000L1011111L0100010000001
1000000011L1000000L0100000000001
1011110011L1001110L0001110000111
1000000011L1000000L0101100000111
1000000011L0000000L1100000000001
1000011111L00E000001100001100001
1111000000L111111100000000001001
11111111111111111111111111111111
11111111111111111111111111111111
