11111111111111111111111111111111
11111111111111111111111111111111
100000000010000000L0000000000001
100010000001011111L0100000000001
111111100001000000L0100000000001
111110000111001110L0000000000001
101100001111000000L0100000000001
100000000000000000L1100000000001
10000110000000000D01100000000001
10100000000111111100011110011111
11100000011111111111111111111111
10000000000111111111111111111111
1000000000000000000010L010000001
1000000000000010000001L110000001
1110000000011111100011L000000001
111L000000011110000110L000000001
111L111111001100001110L000000001
100L000001000000100000L000010001
110L1111001000001000011100011111
110L0000001011111100010000000011
11111111111111111111111100000111
11110000111111111111100000000001
10000000L00L00000000000000000001
11011111L01L11111110000000000001
11000000L01L00000000011000000001
11001110L00L00000110011L00000001
11000000L01L00000111011L11111101
10000000L11L00010000000L00000101
100E0000011L11010000010L11110011
11111111000111111000010L00000011
11111111111111111111111111111111
11111111111111111111111111111111
