11111111111111111111111111111111
11111111111111111111111111111111
100000000000000000L0011111111111
101110011101011111L0111111111111
101111110001000000L0111111111111
101111100001001110L0011111011111
100100000001000000L0111000001111
101000000000000000L1101000001111
10101100000000000D01100000001111
10001000001111111100000000000111
11111000001111111111111111111111
10111100001111111111111111111111
10001000011000000000010000000001
1000000000000L000000000000000001
10L0000000011L110000101110011101
10L1111100011L110000100111011001
10L0000100011L110000000000000001
10L0110110011L110000000000000001
10L1110011001L110110000000011001
1111111111000L000110001110011101
11000111111111111111111000000111
11111111111000000001110000000011
10000000000011111110101100000011
10000000000000100000001100L00001
10000000000000000000001111L00001
10000000000000000000000000L00011
10000000000011001110000111L00011
10000000000000000000000000L00001
10000000000000110110000000L11101
1111100111100010E110000000L10001
11111111111111111111111111111111
11111111111111111111111111111111
