11111111111111111111111111111111
11111111111111111111111111111111
11110000000100000000011111111111
11100000000000000000011111111111
111000LD111011100111011111111111
100000L1111001110110011111011111
100000L1111000000000011000001111
101100L0011000000000001000001111
11111111111000000110000000001111
10001110001011100111000000000111
11111111111110000001111111111111
11111111111000000000011111111111
1000000000000000000000L010000001
1000000000000000000001L110000001
1000000000011000000001L000000001
1000000000011L00000000L000000001
1000000000011L11111100L000000001
1000000000000L00000100L000010001
1000000000010L111100111100011111
1111100111110L000000110000000011
11111111111111111111111100000111
11111111111111111111111100000111
10000000000000000000100110000101
100L0000000000100000000011000001
111L1100001111111000101000011101
111L1100001111100001101111111101
111L1100000011000011100110000001
111L1100000000001000000000000001
101L1101100000001000000011001001
100L0001100011111100000011E11001
11111111111111111111111111111111
11111111111111111111111111111111
