11111111111111111111111111111111
11111111111111011111011111111111
10000000000111000100000000000011
10000000000000000000000010000001
10000000000000000000011111100001
10000000000000000000011110000111
10000000000000000000001100001111
10000000000000011001000000000001
1000000000000001D001000001100001
11111001111011111111001000000001
11111111111111111111111000000111
11111111111000000111110000000011
10000000000011110011101100000011
10111001110000000000001100L00001
10111111000000111110001111L00001
10111110000000000000000000L00011
10010000000111000010000111L00011
10100000000111100110000000L00001
10101100000001001110000000L11101
10001000001000000000000000L10001
11111000001111111111111111111111
10111100001000000001111111111111
10001000011011111110111111111111
10000000000000100000011111111111
10L00000000000000000011111111111
10L11111000000000000011111011111
10L00001000011001110011000001111
10L01101100000000000001000001111
10L11100110000110110000000001111
1111111111000010E110000000000111
11000111111111111111111111111111
11111111111111111111111111111111
