11111111111111111111111111111111
11111111111111111111111111111111
10000000000L00000000000011100001
11110111111L11111110000000001101
11010111111L00000000000000011111
10000000111L00000110000000000001
10000000011L00000111000000000001
10000000000L00010000000001100101
10110000000L11010000000001D00101
11100000011111111000011111111111
11111100011111111111111111111111
11000000001000000111111111111111
10000000001011110011100000000001
10011111000000000000011101111111
1000000L000000111110010101111111
1000000L111000000000000000001111
1110000L111111000010000000000111
1111000L000111100110000000000001
10000001000001001110001100000001
10111011100000000000011000000111
11111111111111111111111111000111
11111111111111111111100000000111
10000000001000000000101111111011
10001000000000100000000010000001
11111110001111111000100000000001
11111000011111100001100000000001
10110000111011000011101100111001
10000010000000001000000000000001
10000010000000001000000011011001
10111111000011111100000010E11001
11111111111111111111111111111111
11111111111111111111111111111111
