11111111111111111111111111111111
11111111111111000011111111111111
10000000000110000001011100000001
11110111111010000000011000000001
1101011111100L0000L0011000LD1111
1000000011100L1111L0000000L11111
1000000001100L0000L0000000L11111
1000000000000L1111L0101100L00111
1011000000000L1111L0111111111111
1110000001110L1110L0000011100011
11111100011111111111111111111111
11000000001111111111111111111111
10110000001000000000100000000001
101100L0000000100000011101111111
101111L0000111111000110101111111
100000L0001111100001100000001111
100111L0001011000011100000000111
100000L0000000001000000000000001
100000L1110000001000001100000001
100000L1000011111100011000000111
11111111111111111111111111000111
11110000111111000011100110011101
11100000010110000001000000001001
10100000000010000000011111101111
100L0000L0000L0000L0001000000001
100L1111L0000L1111L0000000111111
100L0000L0000L0000L0000000000001
100L1111L0100L1111L0100001000001
100L1111L0100L1111L0100011000001
110L1110L0010L1110L000011111E011
11111111111111111111111111111111
11111111111111111111111111111111
