11111111111111111111111111111111
11111111111111000011111111111111
10001110000110000001000000000001
10000000110010000000001110011101
1000000111100L0000L0001111110001
1000000000000L1111L0001111100001
1000000000000L0000L0000100000001
1000011001000L1111L0101000000001
100001D001000L1111L0101011000001
1111111111110L1110L0000010000011
11111111111111111111111110000011
11111111111111111111110000000011
10000000000000000000101100000011
10000000000000100000001100L00001
10000000000111111000001111L00001
10000000000111100001100000L00011
10000000000011000011100111L00011
10000000000000000000000000L00001
10000000000000011000000000L11101
11111001111010000000000000L10001
11111111111110000001111111111111
11110000011100000000111111111111
11110000001000000000011111111111
11100000000000100000011111111111
10000111110000000000011111111111
10000011100011100001111111011111
10100000000011000001111000001111
1010E001100000000000001000001111
11111011000000011000000000001111
11111000010000000010000000000111
11111111111111111111111111111111
11111111111111111111111111111111
