11111111111111111111111111111111
11110111110000000111111111111111
11110001000011110011100000000011
10000000000000000000000010000001
10000000000000111110011111100001
10000000000000000000011110000111
10000000000111000010001100001111
10000110010111100110000000000001
100001D0010001001110000001100001
10111111110000000000001000000001
11111111111111111111111000000111
11111111111000000111100000000001
10L01000000001100011100000000001
11L11000000000000000L00000000001
11L00000000000000011L11000000001
10L00000000011110011L11L00000001
10L00000000000000011L11L11111101
10L00001000000000011L00L00000101
11110001111000011111L10L11110011
11000000001111000000L10L00000011
11110000011111111111111111111111
10000000000111000011100000011111
10000000000110000001000110001111
100000000000100000000000000000L1
1001001111000L0000L00000000011L1
1001001111000L1111L00011110011L1
1001001111000L0000L00000000011L1
10E1101111000L1111L01000000011L1
1111000000000L1111L01000011111L1
1111111111010L1110L00111000000L1
11111111111111111111111111111111
11111111111111111111111111111111
