11111111111111111111111111111111
11111111111111111111111111111111
10000000001000000000000011100001
1000100000000L000000000000001101
1111111000011L110000100000011111
1111100001111L110000100000000001
1011000011111L110000000000000001
1000000000011L110000000001100101
1000011000001L110110000001D00101
1010000000000L000110011111111111
11100000011111111111111111111111
10111100001111111111111111111111
10001000011000000000100000000001
10000000000000100000011101111111
10L00000000111111000110101111111
10L11111000111100001100000001111
10L00001000011000011100000000111
10L01101100000001000000000000001
10L11100110000001000001100000001
11111111110011111100011000000111
11000111111111111111111111000111
11110000011111111111101111000011
11110000001000000000100010000111
11100000000000100000000000000001
1000011111011111100010L000000001
1000001110011110000110L111110001
1010000000001100001110L000010001
1010E00110000000100000L011011001
1111101100000000100000L111001101
11111000010011111100011111111101
11111111111111111111110001111111
11111111111111111111111111111111
