11111111111111111111111111111111
11111111111111111111111111111111
1100000110110000000L010000000001
1100000110100000001L100000000001
111100011010001D001L001110011101
1100000111100111111L000111011001
1100000011100111111L000000000001
1000000000001111111L000000000001
1000000000011111100L000000011001
10001111001111111000001110011101
11111111111111111111111000000111
11111111111111111111110000000011
11111111111100000000000000000001
11111111111000000000000010000001
11111111111011100111000000000001
11111011111001110110001110000111
11110000011000000000001100000111
11110000010000000000000000000001
11110000000000000110000001100001
11100000000011100111000000001001
11111111111110000001111111111111
11111111111001100111011111111111
10000000000000000010000000000011
10000000000111111011100010000001
10000000000010000000011111100011
10000000000000001111111110000111
10000000000000000000001100001111
10000000000000010000000000100001
10000000000000110000000000100001
111110011110011111E0101111110001
11111111111111111111111111111111
11111111111111111111111111111111
