11111111111111111111111111111111
11110111110111111111111111111111
11110001000L0000000000L010000001
10000000000L1111111001L110000001
10000000000L0000000001L000000001
10000000000L0000011000L000000001
10000000000L0000011100L000000001
10000110010L0001000000L000010001
100001D0010L11010000011100011111
10111111110111111000010000000011
11111111111111111111111100000111
11111111111111111111101111000011
100000000000L0100000000010000111
100000000001L1100000000000000001
100000000001L000000000L000000001
100000000000L000000000L111110001
100000000000L000000000L000010001
100000000000L000010000L011011001
1000000000011100011110L111001101
11111001111100000000111111111101
11111111111111000001110001111111
11111111111000000000011111111111
10000000001000000000011111111111
10001000000000000000011111111111
11111110001001001111011111111111
11111000011001001111011111011111
10110000111001001111011000001111
100000100000E1101111001000001111
10000010000111000000000000001111
10111111000111111111000000000111
11111111111111111111111111111111
11111111111111111111111111111111
