11111111111111111111111111111111
11111111111111000011111111111111
110000000L0110000001000000000001
100000001L1010000000011101111111
10001D001L000L0000L0010101111111
100111111L000L1111L0000000001111
100111111L000L0000L0000000000111
101111111L000L1111L0100000000001
111111100L000L1111L0101100000001
1111111000010L1110L0011000000111
11111111111111111111111111000111
11111111111111000011110000000011
11000000000110000001000000000001
10000000000010000000000010000001
1011100111000L0000L0000000000001
1001110110000L1111L0001110000111
1000000000000L0000L0001100000111
1000000000000L1111L0100000000001
1000000110000L1111L0100001100001
1011100111010L1110L0000000001001
11100000011111111111111111111111
11110000011111111111111111111111
11110000001000000000100000000001
11100000000000100000000L00000001
10000111110111111000111L11000011
10000011100111100001111L11000011
10100000000011000011111L11000001
1010E001100000001000011L11000001
11111011000000001000001L11011001
11111000010011111100000L00011001
11111111111111111111111111111111
11111111111111111111111111111111
