11111111111111111111111111111111
11111111111111000011111111111111
10000000000110000001011100000001
11110111111010000000011000000001
1101011111100L0000L0011000LD1111
1000000011100L1111L0000000L11111
1000000001100L0000L0000000L11111
1000000000000L1111L0101100L00111
1011000000000L1111L0111111111111
1110000001110L1110L0000011100011
11111100011111111111111111111111
11100000000111111111111111111111
11000000000000000000000000000001
1110000011100L000000001110011101
1000000000011L110000101111110001
100000000L011L110000101111100001
101111111L011L110000000100000001
101000111L011L110000001000000001
111000110L001L110110001011000001
1100000000100L000110000010000011
11111111111111111111111110000011
10000000011000000111111000000001
10111111101011110011110000000001
10001000000000000000011000001111
10000000000000111110000000000001
10000000000000000000000000000L01
10110011100111000010001111111L01
10000000000111100110001000111L01
10001101100001001110011000110L01
100010E1100000000000010000000011
11111111111111111111111111111111
11111111111111111111111111111111
