11111111111111111111111111111111
11111111111111111111111111111111
110000000L00L0100000010000111111
100000001L11L1100000010000011011
10001D001L01L0000000010000001011
100111111L00L0000000010000000011
100111111L00L0000000010000000011
101111111L00L0000100000000000001
111111100L0111000111100111010011
11111110000100000000101111110111
11111111111111000001111111111111
11111111111011110000111111111111
10000000000000100001111111111111
10111001110000000000011111111111
101111110000L0000000011111111111
101111100000L1111100011111011111
100100000000L0000100011000001111
101000000000L0110110001000001111
101011000000L1110011000000001111
10001000001111111111000000000111
11111000001100011111111111111111
10000000000000000111111111111111
10000000000011110011100000000001
10000000000000000000000000000001
10010011110000111110000000000001
10010011110000000000000000000001
10010011110111000010000000000001
10E11011110111100110000000000001
11110000000001001110000000000001
11111111110000000000011110011111
11111111111111111111111111111111
11111111111111111111111111111111
