11111111111111111111111111111111
11111111111111111111111111111111
1000000000010000000L000000000001
1000000000000000001L111101111111
100000000000001D001L010101111111
1000000000000111111L000000001111
1000000000000111111L000000000111
1000000000001111111L000000000001
1000000000011111100L001100000001
11111001111111111000011000000111
11111111111111111111111111000111
11111111111111000011110000000011
11000000000110000001001100000011
10000000000010000000001100L00001
1011100111000L0000L0001111L00001
1001110110000L1111L0000000L00011
1000000000000L0000L0000111L00011
1000000000000L1111L0100000L00001
1000000110000L1111L0100000L11101
1011100111010L1110L0000000L10001
11100000011111111111111111111111
11000000001000000111100000000111
10110000001001100011101111111011
101100L0000000000000L00010000001
101111L0000000000011L00000000001
100000L0001011110011L00000000001
100111L0001000000011L01100111001
100000L0000000000011L00000000001
100000L1110000011111L00011011001
100000L1000111000000L00010E11001
11111111111111111111111111111111
11111111111111111111111111111111
