11111111111111111111111111111111
11111111111111000000011111111111
11111111111111001000000000000001
11111111111100011110011101111111
11111111111100000000010101111111
11111011111100000101100000001111
1111000001100000L10D100000000111
1111000001011111L111100000000001
1111000000000011L111101100000001
1110000000000000L001111000000111
11111111111111111111111111000111
11111111111111111111110000000011
10000000000100000000000000000001
10000000000000000000000010000001
10000000000011100111000000000001
10000000000001110110001110000111
10000000000000000000001100000111
10000000000000000000000000000001
10000000000000000110000001100001
11111001111011100111000000001001
11111111111110000001111111111111
11111111111000000000011111111111
1L000000000000000000000000000001
1L111111100000000000011000000111
1L000000000001001111011101010111
1L000001100001001111011111111111
1L000001110001001111011010100111
1L0001000000E1101111000000000101
1L110100000111000000000010000111
11111110000111111111000111110001
11111111111111111111111111111111
11111111111111111111111111111111
