11111111111111111111111111111111
11111111111111111111100000000001
11110000000000000000000000011001
11100000000111011111110001L01001
111000LD111101011111100000L00001
100000L1111000000011100000L11001
100000L1111000000001101110L11001
101100L0011000000000001010L11001
11111111111011000000000000011111
10001110001110000001100000011011
11111111111111110001111111111111
11111111111100000000111111111111
10000000000011000000111111111111
1111011111101100L000011111111111
1101011111101111L000011111111111
1000000011100000L000111111011111
1000000001100111L000111000001111
1000000000000000L000001000001111
1011000000000000L111000000001111
1110000001100000L100000000000111
11111100011111111111111111111111
11000000001001100111011111111111
10000000000000000010000000000001
10001000000111111011100000000001
10000000000010000000000000000001
10111000011000001111100000000001
10110000011000000000000000000001
10000000000000010000000000000001
10000110000000110000000000000001
100000001000011111E0111110011111
11111111111111111111111111111111
11111111111111111111111111111111
