11111111111111111111111111111111
11111111111111111111111100000001
10000000001L00000000011100100001
10001000000L11111110010001111001
11111110000L00000000010000000001
11111000011L00000110010000010111
10110000111L00000111000000L10D11
10000000000L00010000011111L11111
10000110000L11010000000011L11111
10100000000111111000000000L00111
11100000011111111111111111111111
10111100001111111111111111111111
10001000011L00000000000000000001
10000000000L11111110001110011101
10L00000000L00000000001111110001
10L11111000L00000110001111100001
10L00001000L00000111000100000001
10L01101100L00010000001000000001
10L11100110L11010000001011000001
11111111110111111000000010000011
11000111111111111111111110000011
10000001111000000000001111000011
10111100111000000000000010000111
10000000000000000000000000000001
1000111110000100111100L000000001
1000000000000100111100L111110001
1111000010000100111100L000010001
111110011000E110111100L011011001
1001001110011100000000L111001101
10000000000111111111011111111101
11111111111111111111110001111111
11111111111111111111111111111111
