11111111111111111111111111111111
11111111111111111111111111111111
10000000L00111000000000000000011
11011111L01110000000000010000001
11000000L0111000LD11111111100001
11001110L0000000L111111110000111
11000000L0100000L111101100001111
10000000L0101100L001100000000001
10000000111111111111100001100001
11111111111000111000101000000001
11111111111111111111111000000111
11111111111111111111110000000011
111111111110L0100000001100000011
111111111111L1100000001100L00001
111111111111L0000000001111L00001
111110111110L0000000000000L00011
111100000110L0000000000111L00011
111100000100L0000100000000L00001
11110000000111000111100000L11101
11100000000100000000100000L10001
11111111111111000001111111111111
11111111111100000000111100001111
1000000000000000000010000000L001
1000000000000111110001011111L011
10000000000000000L0001000000L011
10000000000000000L1111001110L001
10000000000110000L1111000000L011
10000000000111000L0000000000L111
10000000000000000100000E00000111
11111001111011101110011111110001
11111111111111111111111111111111
11111111111111111111111111111111
