11111111111111111111111111111111
11111111111111111111111111111111
1000111000010000000000000000L001
1000000011000000000001011111L011
1000000111101110011101000000L011
1000000000000111011001001110L001
1000000000000000000001000000L011
1000011001000000000000000000L011
100001D0010000000110000000001111
11111111111011100111011111111111
11111111111110000001111111111111
11111111111011110000111111111111
10000000000000100001111111111111
10111001110000000000011111111111
101111110000L0000000011111111111
101111100000L1111100011111011111
100100000000L0000100011000001111
101000000000L0110110001000001111
101011000000L1110011000000001111
10001000001111111111000000000111
11111000001100011111111111111111
11100000000001100111011111111111
11000000000000000010000000000001
11100000111111111011100000000001
10000000000010000000000000000001
100000000L0000001111100000000001
101111111L0000000000000000000001
101000111L0000010000000000000001
111000110L0000110000000000000001
110000000010011111E0111110011111
11111111111111111111111111111111
11111111111111111111111111111111
