11111111111111111111111111111111
11111111111111111111111111111111
10000000L00000000000100000000011
11011111L01000100000000010000001
11000000L01111111000111111100001
11001110L00111100001111110000111
11000000L01011000011101100001111
10000000L11000001000000000000001
1000000D011000001000000001100001
11111111000011111100001000000001
11111111111111111111111000000111
11111111111000000111111000000001
10000000001001100011110000000001
10001000000000000000L11000001111
11111110000000000011L00000000001
11111000011011110011L00000000L01
10110000111000000011L01111111L01
10000000000000000011L01000111L01
10000110000000011111L11000110L01
10100000000111000000L10000000011
11100000011111111111111111111111
10000000000111000011111111111111
10000000000110000001000000000001
10000000000010000000000000000001
1001001111000L0000L0000000000001
1001001111000L1111L0000000000001
1001001111000L0000L0000000000001
10E1101111000L1111L0100000000001
1111000000000L1111L0100000000001
1111111111010L1110L0011110011111
11111111111111111111111111111111
11111111111111111111111111111111
