11111111111111111111111111111111
11111111111111111111111100000001
11000000000000000000111100100001
10000000000000100000010001111001
10111001110111111000110000000001
10011101100111100001110000010111
10000000000011000011100000L10D11
10000000000000001000011111L11111
10000001100000001000000011L11111
10111001110011111100000000L00111
11100000011111111111111111111111
10111100001000000111111111111111
1000100001100110001110L010000001
10000000000000000000L1L110000001
10L00000000000000011L1L000000001
10L11111000011110011L0L000000001
10L00001000000000011L0L000000001
10L01101100000000011L0L000010001
10L11100110000011111L11100011111
11111111110111000000L10000000011
11000111111111111111111100000111
11111111111001100111001111000011
10000000001000000010000010000111
10001000000111111011100000000001
1111111000101000000000L000000001
1111100001100000111110L111110001
1011000011100000000000L000010001
1000001000000001000000L011011001
1000001000000011000000L111001101
101111110000011111E0111111111101
11111111111111111111110001111111
11111111111111111111111111111111
