11111111111111111111111111111111
11111111111000000111111111111111
10001110000001100011100000000011
10000000110000000000L00010000001
10000001111000000011L11111100001
10000000000011110011L11110000111
10000000000000000011L01100001111
10000110010000000011L00000000001
100001D0010000011111L00001100001
11111111111111000000L01000000001
11111111111111111111111000000111
11111111111111111111110000000011
10000000000L00000000000000000001
10111001110L11111110000010000001
10111111000L00000000000000000001
10111110000L00000110001110000111
10010000000L00000111001100000111
10100000000L00010000000000000001
10101100000L11010000000001100001
10001000001111111000000000001001
11111000001111111111111111111111
11000000001001100111011111111111
10000000001000000010000000000011
10011111000111111011100010000001
1000000L000010000000011111100011
1000000L111000001111111110000111
1110000L111000000000001100001111
1111000L000000010000000000100001
10000001000000110000000000100001
101110111000011111E0101111110001
11111111111111111111111111111111
11111111111111111111111111111111
