11111111111111111111111111111111
11111111111111111111111111111111
10L01000000111000000011111111111
11L11000000110000000011111111111
11L0000000011000LD11111111111111
10L0000000000000L111111111011111
10L0000000000000L111111000001111
10L0000100001100L001101000001111
11110001111111111111100000001111
11000000001000111000100000000111
11110000011111111111111111111111
11100000000111111111111111111111
11000000000L00000000000000000001
11100000111L11111110001110011101
10000000000L00000000001111110001
100000000L0L00000110001111100001
101111111L0L00000111000100000001
101000111L0L00010000001000000001
111000110L0L11010000001011000001
11000000001111111000000010000011
11111111111111111111111110000011
11111111111111000001111000000001
10000000000111000000110000000001
10000000000110000000011000001111
10000000000000011111000000000001
10000000000000001110000000000L01
10000000000010000000001111111L01
10000000000010E00110001000111L01
10000000000111101100011000110L01
11111001111111100001010000000011
11111111111111111111111111111111
11111111111111111111111111111111
