11111111111111111111111111111111
11111111111111000011111101111101
10000000001110000001011100010001
10001000000010000000000000000001
1111111000000L0000L0000000000001
1111100001100L1111L0000000000001
1011000011100L0000L0000000000001
1000000000000L1111L0100001100101
1000011000000L1111L0100001D00101
1010000000010L1110L0001111111101
11100000011111111111111111111111
10000000000111111111111111111111
10000000000000000000011111111111
10000000000011100111011111111111
11100000000011111100011111111111
111L0000000011111000011111011111
111L1111110001000000011000001111
100L0000010010000000001000001111
110L1111001010110000000000001111
110L0000001000100000100000000111
11111111111111100000111111111111
11111111111111000001111111111111
1L000000000001100001000000000001
1L111111100000110000000000000001
1L000000000010000111000000000001
1L000001100011111111000000000001
1L000001110001100000000000000001
1L000100000000000000000000000001
1L110100000000110010000000000001
1111111000000011E110011110011111
11111111111111111111111111111111
11111111111111111111111111111111
