11111111111111111111111111111111
11111111111111111111111111111111
10000000000111000000000000000001
10000000000110000000011101111111
1000000000011000LD11110101111111
1000000000000000L111100000001111
1000000000000000L111100000000111
1000000000001100L001100000000001
10000000000111111111101100000001
11111001111000111000111000000111
11111111111111111111111111000111
11111111111111111111110000000011
11000000000000000000000000000001
1000000000000L000000000010000001
1011100111011L110000100000000001
1001110110011L110000101110000111
1000000000011L110000001100000111
1000000000011L110000000000000001
1000000110001L110110000001100001
1011100111000L000110000000001001
11100000011111111111111111111111
11110000011111111111111111111111
11110000001L00000000011111111111
11100000000L11111110011111111111
10000111110L00000000011111111111
10000011100L00000110011111011111
10100000000L00000111011000001111
1010E001100L00010000001000001111
11111011000L11010000000000001111
11111000010111111000000000000111
11111111111111111111111111111111
11111111111111111111111111111111
