11111111111111111111111111111111
11110111110111111111111111111111
11110001000000000000100000000011
10000000000000100000000010000001
10000000000111111000111111100001
10000000000111100001111110000111
10000000000011000011101100001111
10000110010000001000000000000001
100001D0010000001000000001100001
10111111110011111100001000000001
11111111111111111111111000000111
11111111111111000011110000000011
10L01000000110000001000000000011
11L11000000010000000000111110001
11L0000000000L0000L00000000L0001
10L0000000000L1111L00000000L1111
10L0000000000L0000L00110000L1111
10L0000100000L1111L01111000L0001
1111000111100L1111L0100000010001
1100000000110L1110L0001110111001
11110000011111111111111111111111
10000000000111000011111111111111
10000000000110000001000000000011
10000000000010000000000010000001
1001001111000L0000L0011111100011
1001001111000L1111L0011110000111
1001001111000L0000L0001100001111
10E1101111000L1111L0100000100001
1111000000000L1111L0100000100001
1111111111010L1110L0001111110001
11111111111111111111111111111111
11111111111111111111111111111111
