11111111111111111111111111111111
11111111111000000111111111111111
1000000000000110001110000000L001
11110111111000000000L1011111L011
11010111111000000011L1000000L011
10000000111011110011L1001110L001
10000000011000000011L1000000L011
10000000000000000011L0000000L111
10110000000000011111L000000D0111
11100000011111000000L11111110001
11111100011111111111111111111111
10111100001111111111111111111111
10001000011000000000100000000011
10000000000000100000000010000001
10L00000000111111000111111100001
10L11111000111100001111110000111
10L00001000011000011101100001111
10L01101100000001000000000000001
10L11100110000001000000001100001
11111111110011111100001000000001
11000111111111111111111000000111
11111111111000000111100110011101
10000000000001100011100000001001
10000000000000000000L11111101111
10000000000000000011L01000000001
10000000000011110011L00000111111
10000000000000000011L00000000001
10000000000000000011L00001000001
10000000000000011111L00011000001
11111001111111000000L0011111E011
11111111111111111111111111111111
11111111111111111111111111111111
