11111111111111111111111111111111
11111111111111111111111111111111
10000000001111000000000000000001
10001000000110000000000000000001
1111111000011000LD11100000000001
1111100001100000L111100000000001
1011000011100000L111100000000001
1000000000001100L001100000000001
10000110000111111111100000000001
10100000000000111000111110011111
11100000011111111111111111111111
10000000000111111111111111111111
1000000000000000000000L010000001
1000000000000L00000001L110000001
1110000000011L11000011L000000001
111L000000011L11000010L000000001
111L111111011L11000000L000000001
100L000001011L11000000L000010001
110L111100101L110110011100011111
110L000000100L000110010000000011
11111111111111111111111100000111
11111111111111111111111100000111
10000000000L00000000011100000011
100L0000000L11111110011000000001
111L1100001L00000000000001111101
111L1100001L00000110000000111001
111L1100000L00000111001000000001
111L1100000L000100000010E0011001
101L1101100L11010000011110110001
100L0001100111111000011110000101
11111111111111111111111111111111
11111111111111111111111111111111
