11111111111111111111111111111111
11111111111111111111111111111111
1000000000100000000000000000L001
1000100000000L00000001011111L011
1111111000011L11000011000000L011
1111100001111L11000011001110L001
1011000011111L11000001000000L011
1000000000011L11000000000000L111
1000011000001L1101100000000D0111
1010000000000L000110011111110001
11100000011111111111111111111111
10111100001000000111111111111111
10001000011001100011100000000011
10000000000000000000L00010000001
10L00000000000000011L11111100001
10L11111000011110011L11110000111
10L00001000000000011L01100001111
10L01101100000000011L00000000001
10L11100110000011111L00001100001
11111111110111000000L01000000001
11000111111111111111111000000111
10000000011000000111111000000001
10111111101011110011110000000001
10001000000000000000011000001111
10000000000000111110000000000001
10000000000000000000000000000L01
10110011100111000010001111111L01
10000000000111100110001000111L01
10001101100001001110011000110L01
100010E1100000000000010000000011
11111111111111111111111111111111
11111111111111111111111111111111
