11111111111111111111111111111111
11110111110000000111111111111111
11110001000001100011100000000011
10000000000000000000L00010000001
10000000000000000011L11111100001
10000000000011110011L11110000111
10000000000000000011L01100001111
10000110010000000011L00000000001
100001D0010000011111L00001100001
10111111110111000000L01000000001
11111111111111111111111000000111
11111111111111111111101111000011
11000000000000000000000010000111
1000000000000L000000000000000001
1011100111011L11000010L000000001
1001110110011L11000010L111110001
1000000000011L11000000L000010001
1000000000011L11000000L011011001
1000000110001L11011000L111001101
1011100111000L000110011111111101
11100000011111111111110001111111
11110000111111111111100000011111
10000000L00L00000000001111001111
11011111L01L11111110000000000001
11000000L01L00000000000011111001
11001110L00L00000110000000000001
11000000L01L00000111011100001001
10000000L11L00010000011110011001
100E0000011L11010000000100111001
11111111000111111000000000000001
11111111111111111111111111111111
11111111111111111111111111111111
