11111111111111111111111111111111
11111111111111111111111111111111
10000000000000111000011111111111
11110111111000000011011111111111
11010111111000000111111111111111
10000000111000000000011111011111
10000000011000000000011000001111
10000000000000011001001000001111
1011000000000001D001000000001111
11100000011111111111100000000111
11111100011111111111111111111111
11000000001111111111111111111111
1000000000100000000010L010000001
1001111100000010000001L110000001
1000000L00011111100011L000000001
1000000L11111110000110L000000001
1110000L11101100001110L000000001
1111000L00000000100000L000010001
10000001000000001000011100011111
10111011100011111100010000000011
11111111111111111111111100000111
11111111111111111111100000000001
10000000000000000000100000000001
10000000000000100000000000000001
10000000000111111000100100111101
10000000000111100001100100111101
10000000000011000011100100111101
1000000000000000100000E110111101
10000000000000001000011100000001
11111001111011111100011111111101
11111111111111111111111111111111
11111111111111111111111111111111
