11111111111111111111111111111111
11111111111111111111111111111111
110000000L0000000000011111111111
100000001L1111011111111111111111
10001D001L0101011111111111111111
100111111L0000000011111111011111
100111111L0000000001111000001111
101111111L0000000000001000001111
111111100L0011000000000000001111
11111110000110000001100000000111
11111111111111110001111111111111
11111111111100000000111111111111
10000000000011000000100000000011
1000000000001100L000000010000001
1000000000001111L000011111100001
1000000000000000L000111110000111
1000000000000111L000101100001111
1000000000000000L000000000000001
1000000000000000L111000001100001
1111100111100000L100001000000001
11111111111111111111111000000111
11111111111111000011100000000001
10000000001110000001000000000001
10001000000010000000000000000001
1111111000100L0000L0000100111101
1111100001100L1111L0000100111101
1011000011100L0000L0000100111101
1000001000000L1111L010E110111101
1000001000000L1111L0111100000001
1011111100010L1110L0011111111101
11111111111111111111111111111111
11111111111111111111111111111111
