11111111111111111111111111111111
11110000000111111111111111111111
11110010000100000000011111111111
11000111100000000000011111111111
11000000000011100111011111111111
11000001011001110110011111011111
100000L10D1000000000011000001111
111111L1111000000000001000001111
100011L1111000000110000000001111
100000L0011011100111000000000111
11111111111110000001111111111111
11111111111100000000111111111111
10000000000000000000100000000001
10000000000001111100001110011101
10000000000000000L00001111110001
10000000000000000L11101111100001
10000000000110000L11100100000001
10000000000111000L00001000000001
10000000000000000100001011000001
11111001111011101110000010000011
11111111111111111111111110000011
11110000111111000011100000000001
11100000010110000001000000000001
10100000000010000000000000000001
100L0000L0000L0000L0000100111101
100L1111L0000L1111L0000100111101
100L0000L0000L0000L0000100111101
100L1111L0100L1111L010E110111101
100L1111L0100L1111L0111100000001
110L1110L0010L1110L0011111111101
11111111111111111111111111111111
11111111111111111111111111111111
