11111111111111111111111111111111
11111111111111111111111111111111
1000000000000011100000L010000001
1000000000000000001101L110000001
1000000000000000011111L000000001
1000000000000000000000L000000001
1000000000000000000000L000000001
1000000000000001100100L000010001
1000000000000001D001011100011111
11111001111111111111110000000011
11111111111111111111111100000111
11111111111000000111110000000011
10000000000001100011100000000011
11110111111000000000L00111110001
11010111111000000011L000000L0001
10000000111011110011L000000L1111
10000000011000000011L110000L1111
10000000000000000011L111000L0001
10110000000000011111L00000010001
11100000011111000000L01110111001
11111100011111111111111111111111
11000000001111000001111111111111
10000000000111000000111111111111
10001000000110000000011111111111
10000000000000011111011111111111
10111000011000001110011111011111
10110000011010000000011000001111
10000000000010E00110001000001111
10000110000111101100000000001111
10000000100111100001000000000111
11111111111111111111111111111111
11111111111111111111111111111111
