11111111111111111111111111111111
11111111111111111111111111111111
100000000000000000L0000000000011
100000000001011111L0100010000001
100000000001000000L0111111100001
100000000001001110L0011110000111
100000000001000000L0101100001111
100000000000000000L1100000000001
10000000000000000D01100001100001
11111001111111111100001000000001
11111111111111111111111000000111
11111111111111111111110000000011
10L01000000000000000000000000011
11L1100000000L000000000111110001
11L0000000011L1100001000000L0001
10L0000000011L1100001000000L1111
10L0000000011L1100000110000L1111
10L0000100011L1100000111000L0001
1111000111101L110110000000010001
1100000000100L000110001110111001
11110000011111111111111111111111
11000000001111111111100000000001
10000000000L00000000000000000001
10001000000L11111110000000000001
10000000000L00000000000100111101
10111000011L00000110000100111101
10110000011L00000111000100111101
10000000000L0001000000E110111101
10000110000L11010000011100000001
10000000100111111000011111111101
11111111111111111111111111111111
11111111111111111111111111111111
