11111111111111111111111111111111
11111111111111000011111111111111
1100000000011000000100000000L001
1000000000001000000001011111L011
1011100111000L0000L001000000L011
1001110110000L1111L001001110L001
1000000000000L0000L001000000L011
1000000000000L1111L010000000L111
1000000110000L1111L01000000D0111
1011100111010L1110L0011111110001
11100000011111111111111111111111
10000000000000000111111111111111
10000000000011110011100000000001
10000000000000000000011101111111
11100000000000111110010101111111
111L0000000000000000000000001111
111L1111110111000010000000000111
100L0000010111100110000000000001
110L1111001001001110001100000001
110L0000001000000000011000000111
11111111111111111111111111000111
11111111111000000111100000000111
10000000000011110011101111111011
100L0000000000000000000010000001
111L1100001000111110000000000001
111L1100001000000000000000000001
111L1100000111000010001100111001
111L1100000111100110000000000001
101L1101100001001110000011011001
100L0001100000000000000010E11001
11111111111111111111111111111111
11111111111111111111111111111111
