11111111111111111111111111111111
11111111111111111111111111111111
10000000000000111000000000000001
10111001110000000011000000000001
10111111000000000111100000000001
10111110000000000000000000000001
10010000000000000000000000000001
10100000000000011001000000000001
1010110000000001D001000000000001
10001000001111111111111110011111
11111000001111111111111111111111
11100000000111111111111111111111
11000000000L00000000000000000001
11100000111L11111110001110011101
10000000000L00000000001111110001
100000000L0L00000110001111100001
101111111L0L00000111000100000001
101000111L0L00010000001000000001
111000110L0L11010000001011000001
11000000001111111000000010000011
11111111111111111111111110000011
11111111111000000111111100000111
10000000001011110011111100000011
10001000000000000000011000000001
11111110001000111110000001111101
11111000011000000000000000111001
10110000111111000010001000000001
100000100001111001100010E0011001
10000010000001001110011110110001
10111111000000000000011110000101
11111111111111111111111111111111
11111111111111111111111111111111
