11111111111111111111111111111111
11111111111111011111011111111111
10000000000111000100000000000001
10000000000000000000011101111111
10000000000000000000010101111111
10000000000000000000000000001111
10000000000000000000000000000111
10000000000000011001000000000001
1000000000000001D001001100000001
11111001111011111111011000000111
11111111111111111111111111000111
11111111111000000111100000000001
10000000000001100011100000000001
10111001110000000000L00000000001
10111111000000000011L11000000001
10111110000011110011L11L00000001
10010000000000000011L11L11111101
10100000000000000011L00L00000101
10101100000000011111L10L11110011
10001000001111000000L10L00000011
11111000001111111111111111111111
10000000011111111111111111111111
10111111101000000000111111111111
10001000000000100000011111111111
10000000000111111000111111111111
10000000000111100001111111011111
10110011100011000011111000001111
10000000000000001000001000001111
10001101100000001000000000001111
100010E1100011111100000000000111
11111111111111111111111111111111
11111111111111111111111111111111
