11111111111111111111111111111111
11110000000111111111111111111111
11110010000000000000011111111111
11000111100011100111011111111111
11000000000011111100011111111111
11000001011011111000011111011111
100000L10D1001000000011000001111
111111L1111010000000001000001111
100011L1111010110000000000001111
100000L0011000100000100000000111
11111111111111100000111111111111
11111111111000000000011111111111
10000000000000000000000000000011
10000000000000000000000010000001
10000000000110000000011111100001
1000000000011L000000011110000111
1000000000011L111111001100001111
1000000000000L000001000000000001
1000000000010L111100100001100001
1111100111110L000000101000000001
11111111111111111111111000000111
10000000011111111111111000000001
10111111101L00000000010000000001
10001000000L11111110011000001111
10000000000L00000000000000000001
10000000000L00000110000000000L01
10110011100L00000111001111111L01
10000000000L00010000001000111L01
10001101100L11010000011000110L01
100010E1100111111000010000000011
11111111111111111111111111111111
11111111111111111111111111111111
