11111111111111111111111111111111
11111111111111111111100000000001
10000000L00000000000100000011001
11011111L01000100000010001L01001
11000000L01111111000000000L00001
11001110L00111100001100000L11001
11000000L01011000011101110L11001
10000000L11000000000001010L11001
1000000D011000011000000000011111
11111111000010000000000000011011
11111111111110000001111111111111
11111111111011110000111111111111
11111111111000100001100000000001
11111111111000000000001110011101
111111111110L0000000001111110001
111110111110L1111100001111100001
111100000110L0000100000100000001
111100000100L0110110001000000001
111100000000L1110011001011000001
11100000000111111111000010000011
11111111111100011111111110000011
11111111111000000111100000000001
10000000000011110011100000000001
10000000000000000000000000000001
10000000000000111110000100111101
10000000000000000000000100111101
10000000000111000010000100111101
1000000000011110011000E110111101
10000000000001001110011100000001
11111001111000000000011111111101
11111111111111111111111111111111
11111111111111111111111111111111
