11111111111111111111111111111111
11111111111111111111111111111111
10000000000000000000100011100001
11110111111000100000000000001101
11010111111111111000100000011111
10000000111111100001100000000001
10000000011011000011100000000001
10000000000000001000000001100101
10110000000000001000000001D00101
11100000011011111100011111111111
11111100011111111111111111111111
11000000001000000111111111111111
1000000000001111001110L010000001
1000100000000000000001L110000001
1000000000000011111001L000000001
1011100001100000000000L000000001
1011000001111100001000L000000001
1000000000011110011000L000010001
10000110000001001110011100011111
10000000100000000000010000000011
11111111111111111111111100000111
11111111111111111111111100001111
10000000000L0000000000000000L001
100L0000000L1111111001011111L011
111L1100001L0000000001000000L011
111L1100001L0000011001001110L001
111L1100000L0000011101000000L011
111L1100000L0001000000000000L111
101L1101100L11010000000E00000111
100L0001100111111000011111110001
11111111111111111111111111111111
11111111111111111111111111111111
