11111111111111111111111111111111
11111111111111011111011111111111
101001100L0111000100000000000001
1010L0011L1000000000001110011101
1011L1111L1000000000001111110001
1111L1111L1000000000001111100001
111100011L1000000000000100000001
111011000L1000011001001000000001
111011011L100001D001001011000001
11100001111011111111000010000011
11111111111111111111111110000011
11111111111111111111110000000011
111111111110L0100000000000000011
111111111111L1100000000111110001
111111111111L00000000000000L0001
111110111110L00000000000000L1111
111100000110L00000000110000L1111
111100000100L00001000111000L0001
11110000000111000111100000010001
11100000000100000000101110111001
11111111111111000001111111111111
11111111111111000001100000011111
10000000000111000000100110001111
100000000001100000000000000000L1
100000000000000111110000000011L1
100000000000000011100011110011L1
100000000000100000000000000011L1
10000000000010E001100000000011L1
100000000001111011000000011111L1
111110011111111000010111000000L1
11111111111111111111111111111111
11111111111111111111111111111111
