11111111111111111111111111111111
11111111111000000111111111111111
10000000001001100011100011100001
10001000000000000000L00000001101
11111110000000000011L00000011111
11111000011011110011L00000000001
10110000111000000011L00000000001
10000000000000000011L00001100101
10000110000000011111L00001D00101
10100000000111000000L11111111111
11100000011111111111111111111111
11000000001111000011111111111111
10110000001110000001000000000011
101100L0000010000000000010000001
101111L000000L0000L0011111100001
100000L000100L1111L0011110000111
100111L000100L0000L0001100001111
100000L000000L1111L0100000000001
100000L111000L1111L0100001100001
100000L100010L1110L0001000000001
11111111111111111111111000000111
10000001111000000000000000000001
10111100111000000000000000000001
10000000000000000000000000000001
10001111100001001111011000000001
10000000000001001111011L00000001
11110000100001001111011L11111101
111110011000E1101111000L00000101
10010011100111000000010L11110011
10000000000111111111010L00000011
11111111111111111111111111111111
11111111111111111111111111111111
