11111111111111111111111111111111
11111111111111011111011111111111
10000000000111000100010000111111
10111001110000000000010000011011
10111111000000000000010000001011
10111110000000000000010000000011
10010000000000000000010000000011
10100000000000011001000000000001
1010110000000001D001000111010011
10001000001011111111001111110111
11111000001111111111111111111111
10111100001111111111111111111111
100010000110L0100000011111111111
100000000001L1100000011111111111
10L000000001L0000000011111111111
10L111110000L0000000011111011111
10L000010000L0000000011000001111
10L011011000L0000100001000001111
10L11100110111000111100000001111
11111111110100000000100000000111
11000111111111000001111111111111
11111111111111000001111111111111
10000000000001100001000000000001
100L0000000000110000000000000001
111L1100001010000111000000000001
111L1100001011111111000000000001
111L1100000001100000000000000001
111L1100000000000000000000000001
101L1101100000110010000000000001
100L000110000011E110011110011111
11111111111111111111111111111111
11111111111111111111111111111111
