11111111111111111111111111111111
11111111111111111111111111111111
10000000000100000000000011100001
10000000000000000000000000001101
10000000000011100111000000011111
10000000000001110110000000000001
10000000000000000000000000000001
10000000000000000000000001100101
10000000000000000110000001D00101
11111001111011100111011111111111
11111111111110000001111111111111
11111111111100000000111111111111
10000000001000000000011111111111
10001000000000100000011111111111
11111110000000000000011111111111
11111000011011100001111111011111
10110000111011000001111000001111
10000000000000000000001000001111
10000110000000011000000000001111
10100000000000000010000000000111
11100000011111111111111111111111
11110000111111111111100000011111
10000000L00000000000101111001111
11011111L01000100000000000000001
11000000L01111111000100011111001
11001110L00111100001100000000001
11000000L01011000011111100001001
10000000L11000001000011110011001
100E0000011000001000000100111001
11111111000011111100000000000001
11111111111111111111111111111111
11111111111111111111111111111111
