11111111111111111111111111111111
11111111111111111111111111111111
1000000000000011100000000000L001
1011100111000000001101011111L011
1011111100000000011111000000L011
1011111000000000000001001110L001
1001000000000000000001000000L011
1010000000000001100100000000L011
1010110000000001D001000000001111
10001000001111111111111111111111
11111000001111111111111111111111
11100000000111111111111111111111
11000000000000000000011111111111
11100000111111011111111111111111
10000000000101011111111111111111
100000000L0000000011111111011111
101111111L0000000001111000001111
101000111L0000000000001000001111
111000110L0011000000000000001111
11000000001110000001100000000111
11111111111111110001111111111111
11111111111001100111000000011111
10000000000000000010000110001111
100000000001111110111000000000L1
100000000000100000000000000011L1
100000000000000011111011110011L1
100000000000000000000000000011L1
100000000000000100000000000011L1
100000000000001100000000011111L1
111110011110011111E01111000000L1
11111111111111111111111111111111
11111111111111111111111111111111
