11111111111111111111111111111111
11111111111111111111111111111111
10000000L00L00000000000000000011
11011111L01L11111110000010000001
11000000L01L00000000011111100001
11001110L00L00000110011110000111
11000000L01L00000111001100001111
10000000L11L00010000000000000001
1000000D011L11010000000001100001
11111111000111111000001000000001
11111111111111111111111000000111
11111111111000000111111000000001
10000000001001100011110000000001
10001000000000000000L11000001111
11111110000000000011L00000000001
11111000011011110011L00000000L01
10110000111000000011L01111111L01
10000000000000000011L01000111L01
10000110000000011111L11000110L01
10100000000111000000L10000000011
11100000011111111111111111111111
10111100001000000000011111111111
10001000011000000000000000000001
10000000000000000000000000000001
10L00000000001001111000000000001
10L11111000001001111000000000001
10L00001000001001111000000000001
10L011011000E1101111000000000001
10L11100110111000000000000000001
11111111110111111111011110011111
11000111111111111111111111111111
11111111111111111111111111111111
