11111111111111111111111111111111
11111111111000000111111111111111
110000000L0011110011100000000011
100000001L1000000000000010000001
10001D001L0000111110011111100001
100111111L0000000000011110000111
100111111L0111000010001100001111
101111111L0111100110000000000001
111111100L0001001110000001100001
11111110000000000000001000000001
11111111111111111111111000000111
11111111111111111111100000000001
11111111111000000000100000000001
11111111111000100000000000000001
11111111111111111000011000000001
11111011111111100001111L00000001
11110000011011000011111L11111101
11110000010000000000000L00000101
11110000000000011000010L11110011
11100000000010000000010L00000011
11111111111110000001111111111111
11111111111001100111011111111111
10000000000000000010000000000001
10000000000111111011100L00000001
10000000000010000000011L11000011
10000000000000001111111L11000011
10000000000000000000011L11000001
10000000000000010000011L11000001
10000000000000110000001L11011001
111110011110011111E0100L00011001
11111111111111111111111111111111
11111111111111111111111111111111
