11111111111111111111111111111111
11111111111111111111111111111111
1000000000100000000000000000L001
1000100000000L00000001011111L011
1111111000011L11000011000000L011
1111100001111L11000011001110L001
1011000011111L11000001000000L011
1000000000011L11000000000000L111
1000011000001L1101100000000D0111
1010000000000L000110011111110001
11100000011111111111111111111111
11000000001000000111111111111111
10000000001001100011100000000011
10011111000000000000L00010000001
1000000L000000000011L11111100001
1000000L111011110011L11110000111
1110000L111000000011L01100001111
1111000L000000000011L00000000001
10000001000000011111L00001100001
10111011100111000000L01000000001
11111111111111111111111000000111
11111111111000000001110000000011
10000000000011111110100000000001
10000000000000100000000010000001
10000000000000000000000000000001
10000000000000000000001110000111
10000000000011001110001100000111
10000000000000000000000000000001
10000000000000110110000001100001
1111100111100010E110000000001001
11111111111111111111111111111111
11111111111111111111111111111111
