11111111111111111111111111111111
11111111111111111111111101111101
10000000000000000000011100010001
1111011111100L000000000000000001
1101011111111L110000100000000001
1000000011111L110000100000000001
1000000001111L110000000000000001
1000000000011L110000000001100101
1011000000001L110110000001D00101
1110000001100L000110001111111101
11111100011111111111111111111111
11000000001111111111111111111111
101100000010L0100000011111111111
101100L00001L1100000011111111111
101111L00001L0000000011111111111
100000L00010L0000000011111011111
100111L00010L0000000011000001111
100000L00000L0000100001000001111
100000L1110111000111100000001111
100000L1000100000000100000000111
11111111111111000001111111111111
11111111111110000000011100001111
1000000000010000000000000000L001
1000000000011000001111011111L011
1000000000000000000001000000L011
1000000000000000000L01001110L001
1000000000001111111L01000000L011
1000000000001000111L00000000L111
1000000000011000110L000E00000111
11111001111100000000111111110001
11111111111111111111111111111111
11111111111111111111111111111111
