11111111111111111111111111111111
11111111111111111111111111111111
1000111000000000000010L010000001
1000000011000010000001L110000001
1000000111111111100011L000000001
1000000000011110000110L000000001
1000000000001100001110L000000001
1000011001000000100000L000010001
100001D0010000001000011100011111
11111111111011111100010000000011
11111111111111111111111100000111
11111111111111000011100000000001
10000000001110000001000000000001
10001000000010000000000000000001
1111111000000L0000L0011000000001
1111100001100L1111L0011L00000001
1011000011100L0000L0011L11111101
1000000000000L1111L0100L00000101
1000011000000L1111L0110L11110011
1010000000010L1110L0010L00000011
11100000011111111111111111111111
10000000000000000111100000011111
10000000000011110011101111001111
10000000000000000000000000000001
10010011110000111110000011111001
10010011110000000000000000000001
10010011110111000010011100001001
10E11011110111100110011110011001
11110000000001001110000100111001
11111111110000000000000000000001
11111111111111111111111111111111
11111111111111111111111111111111
