11111111111111111111111111111111
11111111111111111111111111111111
1000000000100000000000000000L001
1000100000000L00000001011111L011
1111111000011L11000011000000L011
1111100001111L11000011001110L001
1011000011111L11000001000000L011
1000000000011L11000000000000L111
1000011000001L1101100000000D0111
1010000000000L000110011111110001
11100000011111111111111111111111
10111100001000000111111111111111
10001000011011110011100000000001
10000000000000000000001110011101
10L00000000000111110001111110001
10L11111000000000000001111100001
10L00001000111000010000100000001
10L01101100111100110001000000001
10L11100110001001110001011000001
11111111110000000000000010000011
11000111111111111111111110000011
10000001111111000011100000000111
10011000111110000001001111111011
1000000000L010000000000010000001
1000000011L00L0000L0000000000001
1011110011L00L1111L0000000000001
1000000011L00L0000L0001100111001
1000000011L00L1111L0100000000001
1000011111L00L1111L0100011011001
1111000000L10L1110L0000010E11001
11111111111111111111111111111111
11111111111111111111111111111111
