11111111111111111111111111111111
11111111111111000000011111111111
10000000000111001000000000000001
10000000000100011110001110011101
10000000000100000000001111110001
10000000000100000101101111100001
1000000000000000L10D100100000001
1000000000011111L111101000000001
1000000000000011L111101011000001
1111100111100000L001100010000011
11111111111111111111111110000011
11111111111000000111100000000001
10000000000011110011100000000001
10111001110000000000000000000001
10111111000000111110011000000001
10111110000000000000011L00000001
10010000000111000010011L11111101
10100000000111100110000L00000101
10101100000001001110010L11110011
10001000001000000000010L00000011
11111000001111111111111111111111
11100000000000000000011111111111
11000000000000000000000000000001
11100000111000000000000L00000001
10000000000001001111011L11000011
100000000L0001001111011L11000011
101111111L0001001111011L11000001
101000111L00E1101111011L11000001
111000110L0111000000001L11011001
11000000001111111111000L00011001
11111111111111111111111111111111
11111111111111111111111111111111
