11111111111111111111111111111111
11111111111111111111111111111111
10000000001000000000111100000001
10001000000000100000011000000001
11111110000111111000111000LD1111
11111000011111100001100000L11111
10110000111011000011100000L11111
10000000000000001000001100L00111
10000110000000001000011111111111
10100000000011111100000011100011
11100000011111111111111111111111
11000000001111111111111111111111
10000000000000000000111111111111
10001000000000100000011111111111
10000000000111111000011111111111
10111000011111100001111111011111
10110000011011000011111000001111
10000000000000000000001000001111
10000110000000011000000000001111
10000000100010000000000000000111
11111111111110000001111111111111
11111111111000000000000000011111
10000000000000000000000110001111
100000000000000000000000000000L1
100000000000010011110000000011L1
100000000000010011110011110011L1
100000000000010011110000000011L1
100000000000E11011110000000011L1
100000000001110000000000011111L1
111110011111111111110111000000L1
11111111111111111111111111111111
11111111111111111111111111111111
