11111111111111111111111111111111
11111111111111111111111100000001
11111111111000000000011100100001
11111111111111011111110001111001
11111111111101011111110000000001
11111011111000000011110000010111
11110000011000000001100000L10D11
11110000010000000000011111L11111
11110000000011000000000011L11111
11100000000110000001100000L00111
11111111111111110001111111111111
11111111111110000000011111111111
10000000000100000000010000000001
10000000000110000011100000000001
10000000000000000000001110011101
1000000000000000000L000111011001
1000000000001111111L000000000001
1000000000001000111L000000000001
1000000000011000110L000000011001
11111001111100000000101110011101
11111111111111111111111000000111
10000001111000000000001111000011
10111100111000000000000010000111
10000000000000000000000000000001
1000111110000100111100L000000001
1000000000000100111100L111110001
1111000010000100111100L000010001
111110011000E110111100L011011001
1001001110011100000000L111001101
10000000000111111111011111111101
11111111111111111111110001111111
11111111111111111111111111111111
