11111111111111111111111111111111
11111111111000000111111111111111
110000000L0001100011100000000001
100000001L1000000000L11101111111
10001D001L0000000011L10101111111
100111111L0011110011L00000001111
100111111L0000000011L00000000111
101111111L0000000011L00000000001
111111100L0000011111L01100000001
11111110000111000000L11000000111
11111111111111111111111111000111
11111111111000000111101111000011
11000000000001100011100010000111
10000000000000000000L00000000001
10111001110000000011L0L000000001
10011101100011110011L0L111110001
10000000000000000011L0L000010001
10000000000000000011L0L011011001
10000001100000011111L0L111001101
10111001110111000000L11111111101
11100000011111111111110001111111
10111100001000000111100000000111
10001000011011110011101111111011
10000000000000000000000010000001
10L00000000000111110000000000001
10L11111000000000000000000000001
10L00001000111000010001100111001
10L01101100111100110000000000001
10L11100110001001110000011011001
11111111110000000000000010E11001
11000111111111111111111111111111
11111111111111111111111111111111
