11111111111111111111111111111111
11111111111000000111111111111111
10000000001011110011110000000L01
10001000000000000000000000001L11
1111111000000011111000001D001L01
11111000011000000000000111111L01
10110000111111000010000111111L01
10000000000111100110001111111L01
10000110000001001110011111100L01
10100000000000000000011111100001
11100000011111111111111111111111
11000000001111111111111111111111
10000000001000000000111111111111
10011111000000100000011111111111
1000000L000111111000011111111111
1000000L111111100001111111011111
1110000L111011000011111000001111
1111000L000000000000001000001111
10000001000000011000000000001111
10111011100010000000000000000111
11111111111110000001111111111111
11111111111111000001100000011111
10000000000111000000101111001111
10000000000110000000000000000001
10000000000000011111000011111001
10000000000000001110000000000001
10000000000010000000011100001001
10000000000010E00110011110011001
10000000000111101100000100111001
11111001111111100001000000000001
11111111111111111111111111111111
11111111111111111111111111111111
