11111111111111111111111111111111
11111111111000000111111111111111
10000000L00011110011110000000001
11011111L01000000000000000000001
11000000L01000111110001110011101
11001110L00000000000000111011001
11000000L01111000010000000000001
10000000L11111100110000000000001
1000000D011001001110000000011001
11111111000000000000001110011101
11111111111111111111111000000111
11111111111111111111110000000011
11111111111000000000101100000011
11111111111000100000001100L00001
11111111111111111000001111L00001
11111011111111100001100000L00011
11110000011011000011100111L00011
11110000010000000000000000L00001
11110000000000011000000000L11101
11100000000010000000000000L10001
11111111111110000001111111111111
11111111111100000000111100001111
1000000000000000000010000000L001
1000000000000111110001011111L011
10000000000000000L0001000000L011
10000000000000000L1111001110L001
10000000000110000L1111000000L011
10000000000111000L0000000000L111
10000000000000000100000E00000111
11111001111011101110011111110001
11111111111111111111111111111111
11111111111111111111111111111111
