11111111111111111111111111111111
11111111111111111111111101111101
10000000000000000000111100010001
10000000000000100000000000000001
10000000000111111000000000000001
10000000000111100001100000000001
10000000000011000011100000000001
10000000000000000000000001100101
10000000000000011000000001D00101
11111001111010000000001111111101
11111111111110000001111111111111
11111111111100000000111111111111
10000000001000000000111111111111
10001000000001111100011111111111
11111110000000000L00011111111111
11111000011000000L11111111011111
10110000111110000L11111000001111
10000000000111000L00001000001111
10000110000000000100000000001111
10100000000011101110000000000111
11100000011111111111111111111111
11110000111000000111111100001111
10000000L00001100011111000000101
11011111L01000000000L01000000001
11000000L01000000011L00L0000L001
11001110L00011110011L00L1111L001
11000000L01000000011L00L0000L001
10000000L11000000011L00L1111L011
100E0000011000011111L00L1111L011
11111111000111000000L10L1110L001
11111111111111111111111111111111
11111111111111111111111111111111
