11111111111111111111111111111111
11111111111111111111111111111111
11111111111000000000010000000L01
11111111111111011111100000001L11
1111111111110101111110001D001L01
11111011111000000011100111111L01
11110000011000000001100111111L01
11110000010000000000001111111L01
11110000000011000000011111100L01
11100000000110000001111111100001
11111111111111110001111111111111
11111111111100000000111111111111
10000000000011000000100000000001
1000000000001100L000001110011101
1000000000001111L000001111110001
1000000000000000L000101111100001
1000000000000111L000100100000001
1000000000000000L000001000000001
1000000000000000L111001011000001
1111100111100000L100000010000011
11111111111111111111111110000011
10000001111000000000010000000011
10011000111000000000001100000011
1000000000L000000000001100L00001
1000000011L001001111001111L00001
1011110011L001001111000000L00011
1000000011L001001111000111L00011
1000000011L0E1101111000000L00001
1000011111L111000000000000L11101
1111000000L111111111000000L10001
11111111111111111111111111111111
11111111111111111111111111111111
