11111111111111111111111111111111
11111111111000000111111111111111
1000000000000110001110000000L001
11110111111000000000L1011111L011
11010111111000000011L1000000L011
10000000111011110011L1001110L001
10000000011000000011L1000000L011
10000000000000000011L0000000L111
10110000000000011111L000000D0111
11100000011111000000L11111110001
11111100011111111111111111111111
10111100001000000111111111111111
10001000011011110011100000000011
10000000000000000000000010000001
10L00000000000111110011111100001
10L11111000000000000011110000111
10L00001000111000010001100001111
10L01101100111100110000000000001
10L11100110001001110000001100001
11111111110000000000001000000001
11000111111111111111111000000111
11110000111111111111101111000011
10000000L00000000000100010000111
11011111L01000100000000000000001
11000000L0111111100010L000000001
11001110L0011110000110L111110001
11000000L0101100001110L000010001
10000000L1100000100000L011011001
100E000001100000100000L111001101
11111111000011111100011111111101
11111111111111111111110001111111
11111111111111111111111111111111
