11111111111111111111111111111111
11111111111000000111111111111111
110000000L0011110011110000000001
100000001L1000000000000000000001
10001D001L0000111110001110011101
100111111L0000000000000111011001
100111111L0111000010000000000001
101111111L0111100110000000000001
111111100L0001001110000000011001
11111110000000000000001110011101
11111111111111111111111000000111
11111111111000000111111000000001
10000000001011110011110000000001
10001000000000000000011000001111
11111110000000111110000000000001
11111000011000000000000000000L01
10110000111111000010001111111L01
10000000000111100110001000111L01
10000110000001001110011000110L01
10100000000000000000010000000011
11100000011111111111111111111111
10111100001000000111100000000001
10001000011011110011100000000001
10000000000000000000000000000001
10L00000000000111110000100111101
10L11111000000000000000100111101
10L00001000111000010000100111101
10L0110110011110011000E110111101
10L11100110001001110011100000001
11111111110000000000011111111101
11000111111111111111111111111111
11111111111111111111111111111111
