11111111111111111111111111111111
11111111111111111111111111111111
11111111111111000000000000000011
11111111111110000000000010000001
1111111111111000LD11111111100001
1111101111100000L111111110000111
1111000001100000L111101100001111
1111000001001100L001100000000001
11110000000111111111100001100001
11100000000000111000101000000001
11111111111111111111111000000111
11111111111111111111110000000011
10000000000000000000100000000001
10000000000000100000000010000001
10000000000111111000000000000001
10000000000111100001101110000111
10000000000011000011101100000111
10000000000000000000000000000001
10000000000000011000000001100001
11111001111010000000000000001001
11111111111110000001111111111111
10000000000110000000011111111111
10000000000100000000000000000001
10000000000110000011111000000111
10010011110000000000011101010111
1001001111000000000L011111111111
1001001111001111111L011010100111
10E1101111001000111L000000000101
1111000000011000110L000010000111
11111111110100000000100111110001
11111111111111111111111111111111
11111111111111111111111111111111
