11111111111111111111111111111111
11111111111111000011111111111111
110000000L0110000001010000000001
100000001L1010000000000000000001
10001D001L000L0000L0001110011101
100111111L000L1111L0000111011001
100111111L000L0000L0000000000001
101111111L000L1111L0100000000001
111111100L000L1111L0100000011001
1111111000010L1110L0001110011101
11111111111111111111111000000111
11111111111111111111100000000001
10000000000000000000000000000001
10000000000111011111100000000001
10000000000101011111111000000001
10000000000000000011111L00000001
10000000000000000001111L11111101
10000000000000000000000L00000101
10000000000011000000010L11110011
11111001111110000001110L00000011
11111111111111110001111111111111
10000001111001100111011111111111
10011000111000000010011111111111
1000000000L111111011111111111111
1000000011L010000000011111111111
1011110011L000001111111111011111
1000000011L000000000011000001111
1000000011L000010000001000001111
1000011111L000110000000000001111
1111000000L0011111E0100000000111
11111111111111111111111111111111
11111111111111111111111111111111
