11111111111111111111111111111111
11111111111111011111011111111111
1111111111111100010000L010000001
1111111111100000000001L110000001
1111111111100000000001L000000001
1111101111100000000000L000000001
1111000001100000000000L000000001
1111000001000001100100L000010001
1111000000000001D001011100011111
11100000000011111111010000000011
11111111111111111111111100000111
11111111111111111111111000000001
100000000000L0100000010000000001
100000000001L1100000011000001111
100000000001L0000000000000000001
100000000000L0000000000000000L01
100000000000L0000000001111111L01
100000000000L0000100001000111L01
10000000000111000111111000110L01
11111001111100000000110000000011
11111111111111000001111111111111
10000001111001100111011111111111
10011000111000000010000000000001
1000000000L111111011111000000111
1000000011L010000000011101010111
1011110011L000001111111111111111
1000000011L000000000011010100111
1000000011L000010000000000000101
1000011111L000110000000010000111
1111000000L0011111E0100111110001
11111111111111111111111111111111
11111111111111111111111111111111
