11111111111111111111111111111111
11111111111111011111011111111111
11000000000111000100000000000001
10000000000000000000000000000001
10111001110000000000000000000001
10011101100000000000000000000001
10000000000000000000000000000001
10000000000000011001000000000001
1000000110000001D001000000000001
10111001110011111111011110011111
11100000011111111111111111111111
11000000001111111111111111111111
10000000000000000000000000000001
1000100000000L000000001110011101
1000000000011L110000101111110001
1011100001111L110000101111100001
1011000001111L110000000100000001
1000000000011L110000001000000001
1000011000001L110110001011000001
1000000010000L000110000010000011
11111111111111111111111110000011
11110000111111111111111100000111
11100000010L00000000011100000011
10100000000L11111110011000000001
100L0000L00L00000000000001111101
100L1111L00L00000110000000111001
100L0000L00L00000111001000000001
100L1111L01L000100000010E0011001
100L1111L01L11010000011110110001
110L1110L00111111000011110000101
11111111111111111111111111111111
11111111111111111111111111111111
