11111111111111111111111111111111
11110000000111111111111111111111
11110010000L00000000000000000001
11000111100L11111110001110011101
11000000000L00000000001111110001
11000001011L00000110001111100001
100000L10D1L00000111000100000001
111111L1111L00010000001000000001
100011L1111L11010000001011000001
100000L0011111111000000010000011
11111111111111111111111110000011
11111111111000000111110000000011
10000000000001100011100000000011
10111001110000000000L00111110001
10111111000000000011L000000L0001
10111110000011110011L000000L1111
10010000000000000011L110000L1111
10100000000000000011L111000L0001
10101100000000011111L00000010001
10001000001111000000L01110111001
11111000001111111111111111111111
11110000011111111111111100001111
11110000001000000000011000000101
1110000000000L000000001000000001
1000011111011L110000100L0000L001
1000001110011L110000100L1111L001
1010000000011L110000000L0000L001
1010E00110011L110000000L1111L011
1111101100001L110110000L1111L011
1111100001000L000110010L1110L001
11111111111111111111111111111111
11111111111111111111111111111111
