11111111111111111111111111111111
11111111111000000111111111111111
10001110000001100011100000000011
10000000110000000000L00010000001
10000001111000000011L11111100001
10000000000011110011L11110000111
10000000000000000011L01100001111
10000110010000000011L00000000001
100001D0010000011111L00001100001
11111111111111000000L01000000001
11111111111111111111111000000111
11111111111000000111110000000011
11000000000001100011100000000001
10000000000000000000L00010000001
10111001110000000011L00000000001
10011101100011110011L01110000111
10000000000000000011L01100000111
10000000000000000011L00000000001
10000001100000011111L00001100001
10111001110111000000L00000001001
11100000011111111111111111111111
11000000001111111111111100000111
10110000001L00000000011100000011
101100L0000L11111110011000000001
101111L0000L00000000000001111101
100000L0001L00000110000000111001
100111L0001L00000111001000000001
100000L0000L000100000010E0011001
100000L1110L11010000011110110001
100000L1000111111000011110000101
11111111111111111111111111111111
11111111111111111111111111111111
