11111111111111111111111111111111
11110111110111111111111111111111
11110001000L00000000010000000001
10000000000L11111110000000000001
10000000000L00000000001110011101
10000000000L00000110000111011001
10000000000L00000111000000000001
10000110010L00010000000000000001
100001D0010L11010000000000011001
10111111110111111000001110011101
11111111111111111111111000000111
11111111111000000111110000000011
10L01000000001100011101100000011
11L11000000000000000L01100L00001
11L00000000000000011L01111L00001
10L00000000011110011L00000L00011
10L00000000000000011L00111L00011
10L00001000000000011L00000L00001
11110001111000011111L00000L11101
11000000001111000000L00000L10001
11110000011111111111111111111111
11100000000111000001111111111111
11000000000111000000100000000001
11100000111110000000000000000001
10000000000000011111000000000001
100000000L0000001110000000000001
101111111L0010000000000000000001
101000111L0010E00110000000000001
111000110L0111101100000000000001
11000000001111100001011110011111
11111111111111111111111111111111
11111111111111111111111111111111
