11111111111111111111111111111111
11111111111000000111111111111111
110000000L0001100011100000000001
100000001L1000000000L01110011101
10001D001L0000000011L01111110001
100111111L0011110011L01111100001
100111111L0000000011L00100000001
101111111L0000000011L01000000001
111111100L0000011111L01011000001
11111110000111000000L00010000011
11111111111111111111111110000011
11111111111000000111110000000011
10L01000000001100011100000000011
11L11000000000000000L00111110001
11L00000000000000011L000000L0001
10L00000000011110011L000000L1111
10L00000000000000011L110000L1111
10L00001000000000011L111000L0001
11110001111000011111L00000010001
11000000001111000000L01110111001
11110000011111111111111111111111
10111100001111000001111111111111
100010000110011000010L0000000001
100000000000001100000L1111111001
10L000000000100001110L0000000001
10L111110000111111110L0000011001
10L000010000011000000L0000011101
10L011011000000000000L0001000001
10L111001100001100100L1101000001
1111111111000011E110011111100001
11000111111111111111111111111111
11111111111111111111111111111111
