11111111111111111111111111111111
11111111111000000111111111111111
10000000L00011110011110000000001
11011111L01000000000000000000001
11000000L01000111110001110011101
11001110L00000000000000111011001
11000000L01111000010000000000001
10000000L11111100110000000000001
1000000D011001001110000000011001
11111111000000000000001110011101
11111111111111111111111000000111
11111111111000000111110000000011
10L01000000011110011100000000001
11L11000000000000000000010000001
11L00000000000111110000000000001
10L00000000000000000001110000111
10L00000000111000010001100000111
10L00001000111100110000000000001
11110001111001001110000001100001
11000000001000000000000000001001
11110000011111111111111111111111
11110000011000000111111111111111
111100000010011000111L0000000001
11100000000000000000LL1111111001
10000111110000000011LL0000000001
10000011100011110011LL0000011001
10100000000000000011LL0000011101
1010E001100000000011LL0001000001
11111011000000011111LL1101000001
11111000010111000000L11111100001
11111111111111111111111111111111
11111111111111111111111111111111
