11111111111111111111111111111111
11111111111111111111111111111111
10000000001L00000000000011100001
10001000000L11111110000000001101
11111110000L00000000000000011111
11111000011L00000110000000000001
10110000111L00000111000000000001
10000000000L00010000000001100101
10000110000L11010000000001D00101
10100000000111111000011111111111
11100000011111111111111111111111
10000000000111111111111111111111
10000000000000000000010000000001
1000000000000L000000000000000001
1110000000011L110000101110011101
111L000000011L110000100111011001
111L111111011L110000000000000001
100L000001011L110000000000000001
110L111100101L110110000000011001
110L000000100L000110001110011101
11111111111111111111111000000111
10000001111000000111111100000111
10011000111011110011100110000101
1000000000L000000000000011000001
1000000011L000111110001000011101
1011110011L000000000001111111101
1000000011L111000010000110000001
1000000011L111100110000000000001
1000011111L001001110000011001001
1111000000L000000000000011E11001
11111111111111111111111111111111
11111111111111111111111111111111
