11111111111111111111111111111111
11111111111111000011111111111111
10000000000110000001010000000L01
11110111111010000000000000001L11
1101011111100L0000L000001D001L01
1000000011100L1111L0000111111L01
1000000001100L0000L0000111111L01
1000000000000L1111L0101111111L01
1011000000000L1111L0111111100L01
1110000001110L1110L0011111100001
11111100011111111111111111111111
11000000001000000111111111111111
1011000000101111001110L010000001
101100L000000000000001L110000001
101111L000000011111001L000000001
100000L000100000000000L000000001
100111L000111100001000L000000001
100000L000011110011000L000010001
100000L1110001001110011100011111
100000L1000000000000010000000011
11111111111111111111111100000111
11111111111000000000010000000011
10000000000000000000001100000011
10000000000000000000001100L00001
10000000000001001111001111L00001
10000000000001001111000000L00011
10000000000001001111000111L00011
100000000000E1101111000000L00001
10000000000111000000000000L11101
11111001111111111111000000L10001
11111111111111111111111111111111
11111111111111111111111111111111
