11111111111111111111111111111111
11110111110111111111111111111111
11110001000000000000000000000011
1000000000000L000000000010000001
1000000000011L110000111111100001
1000000000011L110000111110000111
1000000000011L110000001100001111
1000011001011L110000000000000001
100001D001001L110110000001100001
1011111111000L000110001000000001
11111111111111111111111000000111
11111111111111111111110000000011
10000000001000000000101100000011
10001000000000100000001100L00001
11111110000111111000101111L00001
11111000011111100001100000L00011
10110000111011000011100111L00011
10000000000000001000000000L00001
10000110000000001000000000L11101
10100000000011111100000000L10001
11100000011111111111111111111111
11110000011111000011111111111111
11110000001110000001000000000011
11100000000010000000000010000001
1000011111000L0000L0011111100011
1000001110000L1111L0011110000111
1010000000000L0000L0001100001111
1010E00110000L1111L0100000100001
1111101100000L1111L0100000100001
1111100001010L1110L0001111110001
11111111111111111111111111111111
11111111111111111111111111111111
