11111111111111111111111111111111
11111111111111111111111100000001
10000000000000000000111100100001
10111001110000100000010001111001
10111111000111111000110000000001
10111110000111100001110000010111
10010000000011000011100000L10D11
10100000000000001000011111L11111
10101100000000001000000011L11111
10001000001011111100000000L00111
11111000001111111111111111111111
11000000001111111111111111111111
10000000000000000000111111111111
10001000000000100000011111111111
10000000000111111000011111111111
10111000011111100001111111011111
10110000011011000011111000001111
10000000000000000000001000001111
10000110000000011000000000001111
10000000100010000000000000000111
11111111111110000001111111111111
11111111111000000000011111111111
10000000000000000000000000000001
100L0000000000000000000000000001
111L1100001001001111000000000001
111L1100001001001111000000000001
111L1100000001001111000000000001
111L11000000E1101111000000000001
101L1101100111000000000000000001
100L0001100111111111011110011111
11111111111111111111111111111111
11111111111111111111111111111111
