11111111111111111111111111111111
11111111111111111111111111111111
100000000000000000L0000000000011
100000000001011111L0100010000001
100000000001000000L0111111100001
100000000001001110L0011110000111
100000000001000000L0101100001111
100000000000000000L1100000000001
10000000000000000D01100001100001
11111001111111111100001000000001
11111111111111111111111000000111
11111111111000000111110000000011
10000000001001100011100000000011
10001000000000000000L00111110001
11111110000000000011L000000L0001
11111000011011110011L000000L1111
10110000111000000011L110000L1111
10000000000000000011L111000L0001
10000110000000011111L00000010001
10100000000111000000L01110111001
11100000011111111111111111111111
11000000001000000000011111111111
10000000000000000000011111111111
10001000000000000000011111111111
10000000000001001111011111111111
10111000011001001111011111011111
10110000011001001111011000001111
100000000000E1101111001000001111
10000110000111000000000000001111
10000000100111111111000000000111
11111111111111111111111111111111
11111111111111111111111111111111
