11111111111111111111111111111111
11111111111111111111111111111111
10000000000000111000000000000001
10000000000000000011011101111111
10000000000000000111110101111111
10000000000000000000000000001111
10000000000000000000000000000111
10000000000000011001000000000001
1000000000000001D001001100000001
11111001111111111111111000000111
11111111111111111111111111000111
11111111111111111111101111000011
10000000001L00000000000010000111
10001000000L11111110000000000001
11111110000L0000000000L000000001
11111000011L0000011000L111110001
10110000111L0000011100L000010001
10000000000L0001000000L011011001
10000110000L1101000000L111001101
10100000000111111000011111111101
11100000011111111111110001111111
10000000000000000001111111111111
10000000000011111110100000000011
10000000000000100000000010000001
11100000000000000000011111100011
111L0000000000000000011110000111
111L1111110011001110001100001111
100L0000010000000000000000100001
110L1111001000110110000000100001
110L000000100010E110001111110001
11111111111111111111111111111111
11111111111111111111111111111111
