11111111111111111111111111111111
11111111111111111111111100000001
100000000000L0100000011100100001
100000000001L1100000010001111001
100000000001L0000000010000000001
100000000000L0000000010000010111
100000000000L0000000000000L10D11
100000000000L0000100011111L11111
10000000000111000111100011L11111
11111001111100000000100000L00111
11111111111111000001111111111111
11111111111011110000100000000001
10000000000000100001100000011001
11110111111000000000010001L01001
110101111110L0000000000000L00001
100000001110L1111100000000L11001
100000000110L0000100001110L11001
100000000000L0110110001010L11001
101100000000L1110011000000011111
11100000011111111111000000011011
11111100011100011111111111111111
11000000001000000000011111111111
10000000000000000000011111111111
10001000000000000000011111111111
10000000000001001111011111111111
10111000011001001111011111011111
10110000011001001111011000001111
100000000000E1101111001000001111
10000110000111000000000000001111
10000000100111111111000000000111
11111111111111111111111111111111
11111111111111111111111111111111
