11111111111111111111111111111111
11111111111111111111111111111111
110000000L0L00000000010000000001
100000001L1L11111110000000000001
10001D001L0L00000000001110011101
100111111L0L00000110000111011001
100111111L0L00000111000000000001
101111111L0L00010000000000000001
111111100L0L11010000000000011001
11111110000111111000001110011101
11111111111111111111111000000111
11111111111111111111100000000001
11000000000000000000000000000001
1000000000000L000000000000000001
1011100111011L110000111000000001
1001110110011L110000111L00000001
1000000000011L110000011L11111101
1000000000011L110000000L00000101
1000000110001L110110010L11110011
1011100111000L000110010L00000011
11100000011111111111111111111111
11110000011111111111111111111111
10011000010000000000000000000001
1000110000000L000000000L00000001
1010000111011L110000111L11000011
1011111111011L110000111L11000011
1001100000011L110000011L11000001
1000000000011L110000011L11000001
1000110010001L110110001L11011001
100011E110000L000110000L00011001
11111111111111111111111111111111
11111111111111111111111111111111
