11111111111111111111111111111111
11111111111111111111111111111111
100000000000000000L0000000000001
111101111111011111L0100000000001
110101111111000000L0100000000001
100000001111001110L0000000000001
100000000111000000L0100000000001
100000000000000000L1100000000001
10110000000000000D01100000000001
11100000011111111100011110011111
11111100011111111111111111111111
11000000001111111111111111111111
10000000000L00000000000000000001
10001000000L11111110011101111111
10000000000L00000000010101111111
10111000011L00000110000000001111
10110000011L00000111000000000111
10000000000L00010000000000000001
10000110000L11010000001100000001
10000000100111111000011000000111
11111111111111111111111111000111
10000001111111111111111100000111
10111100111000000000011100000011
1000000000000L000000011000000001
1000111110011L110000100001111101
1000000000011L110000100000111001
1111000010011L110000001000000001
1111100110011L1100000010E0011001
1001001110001L110110011110110001
1000000000000L000110011110000101
11111111111111111111111111111111
11111111111111111111111111111111
