11111111111111111111111111111111
11111111111111111111111111111111
1000000000010000000L010000000001
1000000000000000001L100000000001
100000000000001D001L001110011101
1000000000000111111L000111011001
1000000000000111111L000000000001
1000000000001111111L000000000001
1000000000011111100L000000011001
11111001111111111000001110011101
11111111111111111111111000000111
11111111111111111111100000000001
10000000000000000000000000000001
1111011111100L000000000000000001
1101011111111L110000111000000001
1000000011111L110000111L00000001
1000000001111L110000011L11111101
1000000000011L110000000L00000101
1011000000001L110110010L11110011
1110000001100L000110010L00000011
11111100011111111111111111111111
11000000001000000001111111111111
10000000001011111110100000000011
10011111000000100000000010000001
1000000L000000000000011111100011
1000000L111000000000011110000111
1110000L111011001110001100001111
1111000L000000000000000000100001
10000001000000110110000000100001
1011101110000010E110001111110001
11111111111111111111111111111111
11111111111111111111111111111111
