11111111111111111111111111111111
11111111111111000011111100000001
10000000001110000001011100100001
10001000000010000000010001111001
1111111000000L0000L0010000000001
1111100001100L1111L0010000010111
1011000011100L0000L0000000L10D11
1000000000000L1111L0111111L11111
1000011000000L1111L0100011L11111
1010000000010L1110L0000000L00111
11100000011111111111111111111111
11000000001111111111111111111111
10000000001000000000011111111111
10011111000111011111111111111111
1000000L000101011111111111111111
1000000L111000000011111111011111
1110000L111000000001111000001111
1111000L000000000000001000001111
10000001000011000000000000001111
10111011100110000001100000000111
11111111111111110001111111111111
11110000011000000000011111111111
10011000010000000000000000000001
10001100000000000000000000000001
10100001110110000000000000000001
1011111111011L000000000000000001
1001100000011L111111000000000001
1000000000000L000001000000000001
1000110010010L111100100000000001
100011E110010L000000111110011111
11111111111111111111111111111111
11111111111111111111111111111111
