11111111111111111111111111111111
11111111111111111111111111111111
10000000000000000000000011100001
1111011111100L000000000000001101
1101011111111L110000100000011111
1000000011111L110000100000000001
1000000001111L110000000000000001
1000000000011L110000000001100101
1011000000001L110110000001D00101
1110000001100L000110011111111111
11111100011111111111111111111111
11000000001111111111111111111111
1000000000000000000000L010000001
1000100000000L00000001L110000001
1000000000011L11000011L000000001
1011100001111L11000010L000000001
1011000001111L11000000L000000001
1000000000011L11000000L000010001
1000011000001L110110011100011111
1000000010000L000110010000000011
11111111111111111111111100000111
11111111111000000111111100000111
10000000001011110011100110000101
10001000000000000000000011000001
11111110001000111110001000011101
11111000011000000000001111111101
10110000111111000010000110000001
10000010000111100110000000000001
10000010000001001110000011001001
10111111000000000000000011E11001
11111111111111111111111111111111
11111111111111111111111111111111
