11111111111111111111111111111111
11111111111111111111111111111111
1100001111110000000L000000000011
1100000110100000001L100010000001
110000001010001D001L011111100001
1100000000100111111L011110000111
1100000000100111111L001100001111
1000000000001111111L000000000001
1001110100111111100L000001100001
10111111011111111000001000000001
11111111111111111111111000000111
11111111111111111111110000000011
11111111111000000000100000000001
11111111111000100000000010000001
11111111111111111000000000000001
11111011111111100001101110000111
11110000011011000011101100000111
11110000010000000000000000000001
11110000000000011000000001100001
11100000000010000000000000001001
11111111111110000001111111111111
11111111111011110000111100000111
10000000000000100001111100000011
10000000000000000000011000000001
100000000000L0000000000001111101
100000000000L1111100000000111001
100000000000L0000100001000000001
100000000000L01101100010E0011001
100000000000L1110011011110110001
11111001111111111111011110000101
11111111111100011111111111111111
11111111111111111111111111111111
