11111111111111111111111111111111
11111111111111111111111111111111
11000000000000000000000011100001
1000000000000L000000000000001101
1011100111011L110000100000011111
1001110110011L110000100000000001
1000000000011L110000000000000001
1000000000011L110000000001100101
1000000110001L110110000001D00101
1011100111000L000110011111111111
11100000011111111111111111111111
11000000001000000111111111111111
10000000000001100011100000000011
10001000000000000000L00010000001
10000000000000000011L11111100001
10111000011011110011L11110000111
10110000011000000011L01100001111
10000000000000000011L00000000001
10000110000000011111L00001100001
10000000100111000000L01000000001
11111111111111111111111000000111
11111111111111111111100000000001
10000000000L00000000000000000001
10000000000L11111110000000000001
10000000000L00000000000100111101
10000000000L00000110000100111101
10000000000L00000111000100111101
10000000000L0001000000E110111101
10000000000L11010000011100000001
11111001111111111000011111111101
11111111111111111111111111111111
11111111111111111111111111111111
