11111111111111111111111111111111
11110111110111000011111111111111
11110001000110000001000000000011
10000000000010000000000010000001
1000000000000L0000L0011111100001
1000000000000L1111L0011110000111
1000000000000L0000L0001100001111
1000011001000L1111L0100000000001
100001D001000L1111L0100001100001
1011111111010L1110L0001000000001
11111111111111111111111000000111
11111111111000000111101111000011
11000000000011110011100010000111
10000000000000000000000000000001
1011100111000011111000L000000001
1001110110000000000000L111110001
1000000000011100001000L000010001
1000000000011110011000L011011001
1000000110000100111000L111001101
10111001110000000000011111111101
11100000011111111111110001111111
11100000000111000011111111111111
110000000000000000L0000000000001
111000001111011111L0100000000001
100000000001000000L0100000000001
100000000L01001110L0000000000001
101111111L01000000L0100000000001
101000111L00000000L1100000000001
111000110L000E000001100000000001
11000000001111111100011110011111
11111111111111111111111111111111
11111111111111111111111111111111
