11111111111111111111111111111111
11111111111111111111111101111101
10000000001L00000000011100010001
10001000000L11111110000000000001
11111110000L00000000000000000001
11111000011L00000110000000000001
10110000111L00000111000000000001
10000000000L00010000000001100101
10000110000L11010000000001D00101
10100000000111111000001111111101
11100000011111111111111111111111
11000000001111111111111111111111
10110000001000000000011111111111
101100L0000011100111011111111111
101111L0000011111100011111111111
100000L0001011111000011111011111
100111L0001001000000011000001111
100000L0000010000000001000001111
100000L1110010110000000000001111
100000L1000000100000100000000111
11111111111111100000111111111111
11111111111111000001111111111111
100000000000011000010L0000000001
100000000000001100000L1111111001
100000000000100001110L0000000001
100000000000111111110L0000011001
100000000000011000000L0000011101
100000000000000000000L0001000001
100000000000001100100L1101000001
1111100111100011E110011111100001
11111111111111111111111111111111
11111111111111111111111111111111
