11111111111111111111111111111111
11111111111000000111111111111111
10000000000001100011110000000L01
11110111111000000000L00000001L11
11010111111000000011L0001D001L01
10000000111011110011L00111111L01
10000000011000000011L00111111L01
10000000000000000011L01111111L01
10110000000000011111L11111100L01
11100000011111000000L11111100001
11111100011111111111111111111111
10000000000111000011111111111111
10000000000110000001010000000001
10000000000010000000000000000001
1110000000000L0000L0001110011101
111L000000000L1111L0000111011001
111L111111000L0000L0000000000001
100L000001000L1111L0100000000001
110L111100100L1111L0100000011001
110L000000110L1110L0001110011101
11111111111111111111111000000111
10000001111111111111100110011101
10111100111L00000000000000001001
10000000000L11111110011111101111
10001111100L00000000001000000001
10000000000L00000110000000111111
11110000100L00000111000000000001
11111001100L00010000000001000001
10010011100L11010000000011000001
1000000000011111100000011111E011
11111111111111111111111111111111
11111111111111111111111111111111
