11111111111111111111111111111111
11111111111111111111111111111111
11110000000000000000011111111111
11100000000011100111011111111111
111000LD111011111100011111111111
100000L1111011111000011111011111
100000L1111001000000011000001111
101100L0011010000000001000001111
11111111111010110000000000001111
10001110001000100000100000000111
11111111111111100000111111111111
11111111111011110000111111111111
10000000000000100001100000000011
10000000000000000000000010000001
100000000000L0000000011111100001
100000000000L1111100011110000111
100000000000L0000100001100001111
100000000000L0110110000000000001
100000000000L1110011000001100001
11111001111111111111001000000001
11111111111100011111111000000111
10000001111111111111111100000111
10011000111000000000011100000011
1000000000L00L000000011000000001
1000000011L11L110000100001111101
1011110011L11L110000100000111001
1000000011L11L110000001000000001
1000000011L11L1100000010E0011001
1000011111L01L110110011110110001
1111000000L00L000110011110000101
11111111111111111111111111111111
11111111111111111111111111111111
