11111111111111111111111111111111
11111111111111111111111111111111
10000000000100000000010000000L01
10000000000000000000000000001L11
1000000000001110011100001D001L01
10000000000001110110000111111L01
10000000000000000000000111111L01
10000000000000000000001111111L01
10000000000000000110011111100L01
11111001111011100111011111100001
11111111111110000001111111111111
11111111111100000000111111111111
10L01000000000000000111111111111
11L11000000001111100011111111111
11L00000000000000L00011111111111
10L00000000000000L11111111011111
10L00000000110000L11111000001111
10L00001000111000L00001000001111
11110001111000000100000000001111
11000000001011101110000000000111
11110000011111111111111111111111
11000000001111111111111100001111
10000000001L0000000000000000L001
10011111000L1111111001011111L011
1000000L000L0000000001000000L011
1000000L111L0000011001001110L001
1110000L111L0000011101000000L011
1111000L000L0001000000000000L111
10000001000L11010000000E00000111
10111011100111111000011111110001
11111111111111111111111111111111
11111111111111111111111111111111
