11111111111111111111111111111111
11111111111111111111111111111111
10000000000111000000000000000011
10000000000110000000000010000001
1000000000011000LD11111111100001
1000000000000000L111111110000111
1000000000000000L111101100001111
1000000000001100L001100000000001
10000000000111111111100001100001
11111001111000111000101000000001
11111111111111111111111000000111
11111111111111111111100000000001
11000000000000000000100000000001
10000000000000100000000000000001
10111001110111111000111000000001
10011101100111100001111L00000001
10000000000011000011111L11111101
10000000000000001000000L00000101
10000001100000001000010L11110011
10111001110011111100010L00000011
11100000011111111111111111111111
10000000000111000011111111111111
100000000000000000L0000000000001
100000000001011111L0100L00000001
111000000001000000L0111L11000011
111L00000001001110L0011L11000011
111L11111101000000L0111L11000001
100L00000100000000L1111L11000001
110L111100100E000001101L11011001
110L0000001111111100000L00011001
11111111111111111111111111111111
11111111111111111111111111111111
