11111111111111111111111111111111
11111111111111000000011111111111
10000000000111001000000000000001
10000000000100011110001110011101
10000000000100000000001111110001
10000000000100000101101111100001
1000000000000000L10D100100000001
1000000000011111L111101000000001
1000000000000011L111101011000001
1111100111100000L001100010000011
11111111111111111111111110000011
11111111111111111111110000000011
11000000000000000000000000000001
1000000000000L000000000010000001
1011100111011L110000100000000001
1001110110011L110000101110000111
1000000000011L110000001100000111
1000000000011L110000000000000001
1000000110001L110110000001100001
1011100111000L000110000000001001
11100000011111111111111111111111
10000000000000000000011111111111
10000000000000000000011111111111
10000000000000000000011111111111
11100000000001001111011111111111
111L0000000001001111011111011111
111L1111110001001111011000001111
100L00000100E1101111001000001111
110L1111001111000000000000001111
110L0000001111111111000000000111
11111111111111111111111111111111
11111111111111111111111111111111
