11111111111111111111111111111111
11111111111111111111111111111111
1000000000010000000L000000000001
1000000000000000001L101110011101
100000000000001D001L001111110001
1000000000000111111L001111100001
1000000000000111111L000100000001
1000000000001111111L001000000001
1000000000011111100L001011000001
11111001111111111000000010000011
11111111111111111111111110000011
11111111111111111111111000000001
10000000000L00000000010000000001
11110111111L11111110011000001111
11010111111L00000000000000000001
10000000111L00000110000000000L01
10000000011L00000111001111111L01
10000000000L00010000001000111L01
10110000000L11010000011000110L01
11100000011111111000010000000011
11111100011111111111111111111111
10111100001111000011100000011111
100010000110000000L0000110001111
100000000001011111L01000000000L1
10L000000001000000L01000000011L1
10L111110001001110L00011110011L1
10L000010001000000L01000000011L1
10L011011000000000L11000000011L1
10L1110011000E0000011000011111L1
111111111101111111000111000000L1
11000111111111111111111111111111
11111111111111111111111111111111
