11111111111111111111111111111111
11111111111111111111111100000001
11000000000L00000000011100100001
10000000000L11111110010001111001
10111001110L00000000010000000001
10011101100L00000110010000010111
10000000000L00000111000000L10D11
10000000000L00010000011111L11111
10000001100L11010000000011L11111
10111001110111111000000000L00111
11100000011111111111111111111111
11000000001111111111111111111111
10000000001L00000000000000000001
10011111000L11111110001110011101
1000000L000L00000000001111110001
1000000L111L00000110001111100001
1110000L111L00000111000100000001
1111000L000L00010000001000000001
10000001000L11010000001011000001
10111011100111111000000010000011
11111111111111111111111110000011
10000001111000000111100000000001
10111100111001100011100000000001
10000000000000000000L00000000001
10001111100000000011L00100111101
10000000000011110011L00100111101
11110000100000000011L00100111101
11111001100000000011L0E110111101
10010011100000011111L11100000001
10000000000111000000L11111111101
11111111111111111111111111111111
11111111111111111111111111111111
