11111111111111111111111111111111
11111111111111111111111111111111
11110000000000000000100000000001
11100000000000100000001110011101
111000LD111111111000101111110001
100000L1111111100001101111100001
100000L1111011000011100100000001
101100L0011000001000001000000001
11111111111000001000001011000001
10001110001011111100000010000011
11111111111111111111111110000011
11111111111111111111101111000011
11111111111100000000000010000111
11111111111000000000000000000001
1111111111101110011100L000000001
1111101111100111011000L111110001
1111000001100000000000L000010001
1111000001000000000000L011011001
1111000000000000011000L111001101
11100000000011100111011111111101
11111111111110000001110001111111
11111111111001100111011111111111
100000000000000000100L0000000001
100000000001111110111L1111111001
100000000000100000000L0000000001
100000000000000011111L0000011001
100000000000000000000L0000011101
100000000000000100000L0001000001
100000000000001100000L1101000001
111110011110011111E0111111100001
11111111111111111111111111111111
11111111111111111111111111111111
