11111111111111111111111111111111
11111111111111111111111101111101
10000000000100000000011100010001
10000000000000000000000000000001
10000000000011100111000000000001
10000000000001110110000000000001
10000000000000000000000000000001
10000000000000000000000001100101
10000000000000000110000001D00101
11111001111011100111001111111101
11111111111110000001111111111111
11111111111100000000111111111111
10L01000000011000000111111111111
11L1100000001100L000011111111111
11L0000000001111L000011111111111
10L0000000000000L000111111011111
10L0000000000111L000111000001111
10L0000100000000L000001000001111
1111000111100000L111000000001111
1100000000100000L100000000000111
11110000011111111111111111111111
11110000011111111111111111111111
10011000010L000000000L0000000001
10001100000L111111100L1111111001
10100001110L000000000L0000000001
10111111110L000001100L0000011001
10011000000L000001110L0000011101
10000000000L000100000L0001000001
10001100100L110100000L1101000001
100011E1100111111000011111100001
11111111111111111111111111111111
11111111111111111111111111111111
