11111111111111111111111111111111
11111111111111011111000000000001
10000000000111000100000000011001
10111001110000000000010001L01001
10111111000000000000000000L00001
10111110000000000000000000L11001
10010000000000000000001110L11001
10100000000000011001001010L11001
1010110000000001D001000000011111
10001000001011111111000000011011
11111000001111111111111111111111
11000000001111111111111111111111
10000000000000000000011111111111
10001000000111011111111111111111
10000000000101011111111111111111
10111000011000000011111111011111
10110000011000000001111000001111
10000000000000000000001000001111
10000110000011000000000000001111
10000000100110000001100000000111
11111111111111110001111111111111
11111111111111000011111111111111
100000000000000000L0000000000001
100000000001011111L0100L00000001
100000000001000000L0111L11000011
100000000001001110L0011L11000011
100000000001000000L0111L11000001
100000000000000000L1111L11000001
1000000000000E000001101L11011001
11111001111111111100000L00011001
11111111111111111111111111111111
11111111111111111111111111111111
