11111111111111111111111111111111
11111111111111111111111111111111
1000111000000000000010L010000001
1000000011000010000001L110000001
1000000111111111100011L000000001
1000000000011110000110L000000001
1000000000001100001110L000000001
1000011001000000100000L000010001
100001D0010000001000011100011111
11111111111011111100010000000011
11111111111111111111111100000111
11111111111111111111110000000011
10000000000L00000000000000000001
10111001110L11111110000010000001
10111111000L00000000000000000001
10111110000L00000110001110000111
10010000000L00000111001100000111
10100000000L00010000000000000001
10101100000L11010000000001100001
10001000001111111000000000001001
11111000001111111111111111111111
10000000000001100111000000011111
10000000000000000010001111001111
10000000000111111011100000000001
11100000000010000000000011111001
111L0000000000001111100000000001
111L1111110000000000011100001001
100L0000010000010000011110011001
110L1111001000110000000100111001
110L00000010011111E0100000000001
11111111111111111111111111111111
11111111111111111111111111111111
