11111111111111111111111111111111
11111111111111111111111111111111
10000000000000000000011100000001
1011100111000L000000011000000001
1011111100011L110000111000LD1111
1011111000011L110000100000L11111
1001000000011L110000000000L11111
1010000000011L110000001100L00111
1010110000001L110110011111111111
1000100000100L000110000011100011
11111000001111111111111111111111
11100000000111111111111111111111
11000000000000000000000000000001
1110000011100L000000001110011101
1000000000011L110000101111110001
100000000L011L110000101111100001
101111111L011L110000000100000001
101000111L011L110000001000000001
111000110L001L110110001011000001
1100000000100L000110000010000011
11111111111111111111111110000011
11111111111111000001100000000001
10000000000001100001000000000001
10000000000000110000000000000001
10000000000010000111011000000001
10000000000011111111011L00000001
10000000000001100000011L11111101
10000000000000000000000L00000101
10000000000000110010010L11110011
1111100111100011E110010L00000011
11111111111111111111111111111111
11111111111111111111111111111111
