11111111111111111111111111111111
11111111111111111111111111111111
100000000000L0100000010000000L01
100000000001L1100000000000001L11
100000000001L000000000001D001L01
100000000000L0000000000111111L01
100000000000L0000000000111111L01
100000000000L0000100001111111L01
10000000000111000111111111100L01
11111001111100000000111111100001
11111111111111000001111111111111
11111111111100000000111111111111
1000000000100000000000000000L001
1000100000000010000001011111L011
1111111000000000000001000000L011
1111100001101110000111001110L001
1011000011101100000111000000L011
1000000000000000000000000000L011
10000110000000011000000000001111
10100000000000000010011111111111
11100000011111111111111111111111
11110000011111000011111111111111
10011000010110000001011111111111
10001100000010000000011111111111
1010000111000L0000L0011111111111
1011111111000L1111L0011111011111
1001100000000L0000L0011000001111
1000000000000L1111L0101000001111
1000110010000L1111L0100000001111
100011E110010L1110L0000000000111
11111111111111111111111111111111
11111111111111111111111111111111
