11111111111111111111111111111111
11111111111111000000011111111111
1000000000011100100000L010000001
1000000000010001111001L110000001
1000000000010000000001L000000001
1000000000010000010110L000000001
1000000000000000L10D10L000000001
1000000000011111L11110L000010001
1000000000000011L111111100011111
1111100111100000L001110000000011
11111111111111111111111100000111
11111111111000000111110000000011
10000000000011110011101100000011
10111001110000000000001100L00001
10111111000000111110001111L00001
10111110000000000000000000L00011
10010000000111000010000111L00011
10100000000111100110000000L00001
10101100000001001110000000L11101
10001000001000000000000000L10001
11111000001111111111111111111111
10111100001000000111100110011101
10001000011011110011100000001001
10000000000000000000011111101111
10L00000000000111110001000000001
10L11111000000000000000000111111
10L00001000111000010000000000001
10L01101100111100110000001000001
10L11100110001001110000011000001
1111111111000000000000011111E011
11000111111111111111111111111111
11111111111111111111111111111111
