11111111111111111111111111111111
11110000000111000011111111111111
11110010000110000001000000000001
11000111100010000000011101111111
1100000000000L0000L0010101111111
1100000101100L1111L0000000001111
100000L10D100L0000L0000000000111
111111L111100L1111L0100000000001
100011L111100L1111L0101100000001
100000L001110L1110L0011000000111
11111111111111111111111111000111
11111111111111111111110000000011
10000000000000000000000000000001
1111011111100L000000000010000001
1101011111111L110000100000000001
1000000011111L110000101110000111
1000000001111L110000001100000111
1000000000011L110000000000000001
1011000000001L110110000001100001
1110000001100L000110000000001001
11111100011111111111111111111111
10111100001111111111111100001111
1000100001100000000000000000L001
1000000000000L00000001011111L011
10L0000000011L11000011000000L011
10L1111100011L11000011001110L001
10L0000100011L11000001000000L011
10L0110110011L11000000000000L111
10L1110011001L110110000E00000111
1111111111000L000110011111110001
11000111111111111111111111111111
11111111111111111111111111111111
