11111111111111111111111111111111
11111111111111000011111111111111
1100000000011000000100000000L001
1000000000001000000001011111L011
1011100111000L0000L001000000L011
1001110110000L1111L001001110L001
1000000000000L0000L001000000L011
1000000000000L1111L010000000L111
1000000110000L1111L01000000D0111
1011100111010L1110L0011111110001
11100000011111111111111111111111
11000000001111111111111111111111
10000000001000000000111111111111
10011111000000100000011111111111
1000000L000111111000011111111111
1000000L111111100001111111011111
1110000L111011000011111000001111
1111000L000000000000001000001111
10000001000000011000000000001111
10111011100010000000000000000111
11111111111110000001111111111111
10000000000100000000111111111111
10000000000011000000100000000001
1000000000001100L000000000000001
1001001111001111L000000000000001
1001001111000000L000100000000001
1001001111000111L000100000000001
10E1101111000000L000000000000001
1111000000000000L111000000000001
1111111111000000L100011110011111
11111111111111111111111111111111
11111111111111111111111111111111
