11111111111111111111111111111111
11111111111111111111111101111101
10000000000L00000000011100010001
10111001110L11111110000000000001
10111111000L00000000000000000001
10111110000L00000110000000000001
10010000000L00000111000000000001
10100000000L00010000000001100101
10101100000L11010000000001D00101
10001000001111111000001111111101
11111000001111111111111111111111
11000000001111000011111111111111
10110000001110000001000000000001
101100L0000010000000001110011101
101111L000000L0000L0001111110001
100000L000100L1111L0001111100001
100111L000100L0000L0000100000001
100000L000000L1111L0101000000001
100000L111000L1111L0101011000001
100000L100010L1110L0000010000011
11111111111111111111111110000011
11111111111111000011110000000011
100000000000000000L0001100000011
100000000001011111L0101100L00001
100000000001000000L0101111L00001
100000000001001110L0000000L00011
100000000001000000L0100111L00011
100000000000000000L1100000L00001
1000000000000E000001100000L11101
11111001111111111100000000L10001
11111111111111111111111111111111
11111111111111111111111111111111
