11111111111111111111111111111111
11111111111111111111111111111111
10L01000000000000000000011100001
11L1100000000L000000000000001101
11L0000000011L110000100000011111
10L0000000011L110000100000000001
10L0000000011L110000000000000001
10L0000100011L110000000001100101
1111000111101L110110000001D00101
1100000000100L000110011111111111
11110000011111111111111111111111
10111100001111111111111111111111
100010000110L0100000011111111111
100000000001L1100000011111111111
10L000000001L0000000011111111111
10L111110000L0000000011111011111
10L000010000L0000000011000001111
10L011011000L0000100001000001111
10L11100110111000111100000001111
11111111110100000000100000000111
11000111111111000001111111111111
10011001110100000000111111111111
10000000100000000000000000000001
11111110111000100000000000000001
10100000000000000000000000000001
10000011111011100001100000000001
10000000000011000001100000000001
10000100000000000000000000000001
10001100000000011000000000000001
10011111E01000000010011110011111
11111111111111111111111111111111
11111111111111111111111111111111
