11111111111111111111111111111111
11111111111111111111111111111111
10L01000000000000000010000000L01
11L1100000000L000000000000001L11
11L0000000011L11000010001D001L01
10L0000000011L110000100111111L01
10L0000000011L110000000111111L01
10L0000100011L110000001111111L01
1111000111101L110110011111100L01
1100000000100L000110011111100001
11110000011111111111111111111111
11000000001111111111111111111111
101100000010L0100000011111111111
101100L00001L1100000011111111111
101111L00001L0000000011111111111
100000L00010L0000000011111011111
100111L00010L0000000011000001111
100000L00000L0000100001000001111
100000L1110111000111100000001111
100000L1000100000000100000000111
11111111111111000001111111111111
11111111111000000001100000011111
10000000000011111110101111001111
10000000000000100000000000000001
10000000000000000000000011111001
10000000000000000000000000000001
10000000000011001110011100001001
10000000000000000000011110011001
10000000000000110110000100111001
1111100111100010E110000000000001
11111111111111111111111111111111
11111111111111111111111111111111
