11111111111111111111111111111111
11110000000111000011111111111111
11110010000110000001000000000001
11000111100010000000011101111111
1100000000000L0000L0010101111111
1100000101100L1111L0000000001111
100000L10D100L0000L0000000000111
111111L111100L1111L0100000000001
100011L111100L1111L0101100000001
100000L001110L1110L0011000000111
11111111111111111111111111000111
11111111111111111111101111000011
111111111110L0100000000010000111
111111111111L1100000000000000001
111111111111L000000000L000000001
111110111110L000000000L111110001
111100000110L000000000L000010001
111100000100L000010000L011011001
1111000000011100011110L111001101
11100000000100000000111111111101
11111111111111000001110001111111
11111111111111000001111111111111
100000000001110000001L0000000001
100000000001100000000L1111111001
100000000000000111110L0000000001
100000000000000011100L0000011001
100000000000100000000L0000011101
10000000000010E001100L0001000001
100000000001111011000L1101000001
11111001111111100001011111100001
11111111111111111111111111111111
11111111111111111111111111111111
