11111111111111111111111111111111
11111111111111111111111111111111
1000000000010000000L001001100L01
1011100111000000001L1010L0011L11
101111110000001D001L0011L1111L11
1011111000000111111L0111L1111L11
1001000000000111111L011100011L11
1010000000001111111L011011000L11
1010110000011111100L011011011L11
10001000001111111000011000011111
11111000001111111111111111111111
10000000000111111111111111111111
100000000000L0100000011111111111
100000000001L1100000011111111111
111000000001L0000000011111111111
111L00000000L0000000011111011111
111L11111100L0000000011000001111
100L00000100L0000100001000001111
110L1111001111000111100000001111
110L0000001100000000100000000111
11111111111111000001111111111111
11110000011110000000011111111111
10011000010100000000000000000001
10001100000110000011100000000001
10100001110000000000000000000001
1011111111000000000L000000000001
1001100000001111111L000000000001
1000000000001000111L000000000001
1000110010011000110L000000000001
100011E1100100000000111110011111
11111111111111111111111111111111
11111111111111111111111111111111
