11111111111111111111111111111111
11111111111111111111111111111111
10000000000L00000000000011100001
11110111111L11111110000000001101
11010111111L00000000000000011111
10000000111L00000110000000000001
10000000011L00000111000000000001
10000000000L00010000000001100101
10110000000L11010000000001D00101
11100000011111111000011111111111
11111100011111111111111111111111
11100000000111111111111111111111
11000000000000000000011111111111
11100000111111011111111111111111
10000000000101011111111111111111
100000000L0000000011111111011111
101111111L0000000001111000001111
101000111L0000000000001000001111
111000110L0011000000000000001111
11000000001110000001100000000111
11111111111111110001111111111111
10000001111001100111011111111111
10011000111000000010000000000001
1000000000L111111011100000000001
1000000011L010000000000000000001
1011110011L000001111100000000001
1000000011L000000000000000000001
1000000011L000010000000000000001
1000011111L000110000000000000001
1111000000L0011111E0111110011111
11111111111111111111111111111111
11111111111111111111111111111111
