11111111111111111111111111111111
11111111111111011111011111111111
10000000000111000100000000000001
10000000000000000000001110011101
10000000000000000000001111110001
10000000000000000000001111100001
10000000000000000000000100000001
10000000000000011001001000000001
1000000000000001D001001011000001
11111001111011111111000010000011
11111111111111111111111110000011
11111111111111000011110000000011
10000000001110000001001100000011
10001000000010000000001100L00001
1111111000000L0000L0001111L00001
1111100001100L1111L0000000L00011
1011000011100L0000L0000111L00011
1000000000000L1111L0100000L00001
1000011000000L1111L0100000L11101
1010000000010L1110L0000000L10001
11100000011111111111111111111111
11000000001111111111111100000111
10000000000000000000111100000011
10001000000000100000011000000001
10000000000111111000100001111101
10111000011111100001100000111001
10110000011011000011101000000001
100000000000000010000010E0011001
10000110000000001000011110110001
10000000100011111100011110000101
11111111111111111111111111111111
11111111111111111111111111111111
