11111111111111111111111111111111
11111111111111111111111100000001
10000000000000000000111100100001
11100000011000100000010001111001
11110101011111111000010000000001
11111111111111100001110000010111
11101010011011000011100000L10D11
10000000010000000000011111L11111
10001000011000011000000011L11111
10011111000010000000000000L00111
11111111111110000001111111111111
11111111111011110000111111111111
11111111111000100001100000000011
11111111111000000000000010000001
111111111110L0000000011111100001
111110111110L1111100011110000111
111100000110L0000100001100001111
111100000100L0110110000000000001
111100000000L1110011000001100001
11100000000111111111001000000001
11111111111100011111111000000111
11111111111001100111001111000011
10000000000000000010000010000111
10000000000111111011100000000001
1000000000001000000000L000000001
1000000000000000111110L111110001
1000000000000000000000L000010001
1000000000000001000000L011011001
1000000000000011000000L111001101
111110011110011111E0111111111101
11111111111111111111110001111111
11111111111111111111111111111111
