11111111111111111111111111111111
11111111111111111111111111111111
1000000000011100000000L010000001
1000000000011000000001L110000001
1000000000011000LD1111L000000001
1000000000000000L11110L000000001
1000000000000000L11110L000000001
1000000000001100L00110L000010001
10000000000111111111111100011111
11111001111000111000110000000011
11111111111111111111111100000111
11111111111000000111101111000011
10L01000000001100011100010000111
11L11000000000000000L00000000001
11L00000000000000011L0L000000001
10L00000000011110011L0L111110001
10L00000000000000011L0L000010001
10L00001000000000011L0L011011001
11110001111000011111L0L111001101
11000000001111000000L11111111101
11110000011111111111110001111111
11110000011111111111111111111111
10011000010000000000111111111111
10001100000000100000011111111111
10100001110111111000111111111111
10111111110111100001111111011111
10011000000011000011111000001111
10000000000000001000001000001111
10001100100000001000000000001111
100011E1100011111100000000000111
11111111111111111111111111111111
11111111111111111111111111111111
