11111111111111111111111111111111
11111111111111111111100000000001
10000000001000111000000000011001
10001000000000000011010001L01001
11111110000000000111100000L00001
11111000011000000000000000L11001
10110000111000000000001110L11001
10000000000000011001001010L11001
1000011000000001D001000000011111
10100000000111111111100000011011
11100000011111111111111111111111
10111100001111111111111111111111
10001000011000000000011111111111
10000000000111011111111111111111
10L00000000101011111111111111111
10L11111000000000011111111011111
10L00001000000000001111000001111
10L01101100000000000001000001111
10L11100110011000000000000001111
11111111110110000001100000000111
11000111111111110001111111111111
11111111111111000011111111111111
100000000000000000L00L0000000001
100000000001011111L01L1111111001
100000000001000000L01L0000000001
100000000001001110L00L0000011001
100000000001000000L01L0000011101
100000000000000000L11L0001000001
1000000000000E0000011L1101000001
11111001111111111100011111100001
11111111111111111111111111111111
11111111111111111111111111111111
