11111111111111111111111111111111
11111111111111111111111111111111
10000000L00L00000000000000000011
11011111L01L11111110000010000001
11000000L01L00000000011111100001
11001110L00L00000110011110000111
11000000L01L00000111001100001111
10000000L11L00010000000000000001
1000000D011L11010000000001100001
11111111000111111000001000000001
11111111111111111111111000000111
11111111111111111111101111000011
10000000001000000000100010000111
10001000000000100000000000000001
1111111000011111100010L000000001
1111100001111110000110L111110001
1011000011101100001110L000010001
1000000000000000100000L011011001
1000011000000000100000L111001101
10100000000011111100011111111101
11100000011111111111110001111111
11100000000111000011100000000111
11000000000110000001001111111011
11100000111010000000000010000001
1000000000000L0000L0000000000001
100000000L000L1111L0000000000001
101111111L000L0000L0001100111001
101000111L000L1111L0100000000001
111000110L000L1111L0100011011001
1100000000110L1110L0000010E11001
11111111111111111111111111111111
11111111111111111111111111111111
