11111111111111111111111111111111
11111111111111111111111111111111
100000000000000000L0010000111111
111101111111011111L0110000011011
110101111111000000L0110000001011
100000001111001110L0010000000011
100000000111000000L0110000000011
100000000000000000L1100000000001
10110000000000000D01100111010011
11100000011111111100001111110111
11111100011111111111111111111111
11000000001111111111111111111111
100000000010L0100000011111111111
100111110001L1100000011111111111
1000000L0001L0000000011111111111
1000000L1110L0000000011111011111
1110000L1110L0000000011000001111
1111000L0000L0000100001000001111
10000001000111000111100000001111
10111011100100000000100000000111
11111111111111000001111111111111
11111111111111000011111111111111
100000000000000000L0000000000001
100000000001011111L0100L00000001
100000000001000000L0111L11000011
100000000001001110L0011L11000011
100000000001000000L0111L11000001
100000000000000000L1111L11000001
1000000000000E000001101L11011001
11111001111111111100000L00011001
11111111111111111111111111111111
11111111111111111111111111111111
