11111111111111111111111111111111
11110000000111111111111111111111
11110010000000000000100000000011
11000111100000100000000010000001
11000000000111111000111111100001
11000001011111100001111110000111
100000L10D1011000011101100001111
111111L1111000001000000000000001
100011L1111000001000000001100001
100000L0011011111100001000000001
11111111111111111111111000000111
11111111111111111111101111000011
10000000001L00000000000010000111
10001000000L11111110000000000001
11111110000L0000000000L000000001
11111000011L0000011000L111110001
10110000111L0000011100L000010001
10000000000L0001000000L011011001
10000110000L1101000000L111001101
10100000000111111000011111111101
11100000011111111111110001111111
11110000011111111111111111111111
11110000001000000000100000000001
11100000000000100000000000000001
10000111110111111000100000000001
10000011100111100001100000000001
10100000000011000011100000000001
1010E001100000001000000000000001
11111011000000001000000000000001
11111000010011111100011110011111
11111111111111111111111111111111
11111111111111111111111111111111
