11111111111111111111111111111111
11111111111111000011111111111111
10000000000110000001010000000L01
11110111111010000000000000001L11
1101011111100L0000L000001D001L01
1000000011100L1111L0000111111L01
1000000001100L0000L0000111111L01
1000000000000L1111L0101111111L01
1011000000000L1111L0111111100L01
1110000001110L1110L0011111100001
11111100011111111111111111111111
11000000001000000111111111111111
1000000000001111001110L010000001
1000100000000000000001L110000001
1000000000000011111001L000000001
1011100001100000000000L000000001
1011000001111100001000L000000001
1000000000011110011000L000010001
10000110000001001110011100011111
10000000100000000000010000000011
11111111111111111111111100000111
10000001111111111111100000000111
10011000111000000000001111111011
1000000000L00L000000000010000001
1000000011L11L110000100000000001
1011110011L11L110000100000000001
1000000011L11L110000001100111001
1000000011L11L110000000000000001
1000011111L01L110110000011011001
1111000000L00L000110000010E11001
11111111111111111111111111111111
11111111111111111111111111111111
