11111111111111111111111111111111
11111111111000000111111111111111
10000000000011110011111100000001
10111001110000000000011000000001
10111111000000111110011000LD1111
10111110000000000000000000L11111
10010000000111000010000000L11111
10100000000111100110001100L00111
10101100000001001110011111111111
10001000001000000000000011100011
11111000001111111111111111111111
11100000000111000011111111111111
1100000000011000000100L010000001
1110000011101000000001L110000001
1000000000000L0000L001L000000001
100000000L000L1111L000L000000001
101111111L000L0000L000L000000001
101000111L000L1111L010L000010001
111000110L000L1111L0111100011111
1100000000110L1110L0010000000011
11111111111111111111111100000111
11111111111111111111111100000111
10000000000L00000000011100000011
10000000000L11111110011000000001
10000000000L00000000000001111101
10000000000L00000110000000111001
10000000000L00000111001000000001
10000000000L000100000010E0011001
10000000000L11010000011110110001
11111001111111111000011110000101
11111111111111111111111111111111
11111111111111111111111111111111
