11111111111111111111111111111111
11111111111111111111111111111111
10000000001000000000000011100001
1000100000000L000000000000001101
1111111000011L110000100000011111
1111100001111L110000100000000001
1011000011111L110000000000000001
1000000000011L110000000001100101
1000011000001L110110000001D00101
1010000000000L000110011111111111
11100000011111111111111111111111
11100000000111111111111111111111
11000000000L00000000000000000011
11100000111L11111110000010000001
10000000000L00000000011111100001
100000000L0L00000110011110000111
101111111L0L00000111001100001111
101000111L0L00010000000000000001
111000110L0L11010000000001100001
11000000001111111000001000000001
11111111111111111111111000000111
10000001111111111111100000000001
10011000111000000000100000000001
1000000000L000100000000000000001
1000000011L111111000100100111101
1011110011L111100001100100111101
1000000011L011000011100100111101
1000000011L00000100000E110111101
1000011111L000001000011100000001
1111000000L011111100011111111101
11111111111111111111111111111111
11111111111111111111111111111111
