11111111111111111111111111111111
11111111111111111111111111111111
11000000000111000000010000111111
10000000000110000000010000011011
1011100111011000LD11110000001011
1001110110000000L111110000000011
1000000000000000L111110000000011
1000000000001100L001100000000001
10000001100111111111100111010011
10111001110000111000101111110111
11100000011111111111111111111111
11000000001111111111111111111111
10000000000000000000111111111111
10001000000000100000011111111111
10000000000111111000011111111111
10111000011111100001111111011111
10110000011011000011111000001111
10000000000000000000001000001111
10000110000000011000000000001111
10000000100010000000000000000111
11111111111110000001111111111111
10011001110110000000011111111111
10000000100100000000000000000001
11111110111110000011100000000001
10100000000000000000000000000001
1000001111100000000L000000000001
1000000000001111111L000000000001
1000010000001000111L000000000001
1000110000011000110L000000000001
10011111E01100000000111110011111
11111111111111111111111111111111
11111111111111111111111111111111
