11111111111111111111111111111111
11111111111111111111111111111111
10000000001L00000000000011100001
10001000000L11111110000000001101
11111110000L00000000000000011111
11111000011L00000110000000000001
10110000111L00000111000000000001
10000000000L00010000000001100101
10000110000L11010000000001D00101
10100000000111111000011111111111
11100000011111111111111111111111
11000000001111111111111111111111
10110000001000000000000000000011
101100L000000L000000000010000001
101111L000011L110000111111100001
100000L000111L110000111110000111
100111L000111L110000001100001111
100000L000011L110000000000000001
100000L111001L110110000001100001
100000L100000L000110001000000001
11111111111111111111111000000111
11110000111111111111100000000001
11100000010000000000000000000001
1010000000000L000000000000000001
100L0000L0011L110000100100111101
100L1111L0011L110000100100111101
100L0000L0011L110000000100111101
100L1111L0111L11000000E110111101
100L1111L0101L110110011100000001
110L1110L0000L000110011111111101
11111111111111111111111111111111
11111111111111111111111111111111
