11111111111111111111111111111111
11111111111111111111111111111111
1000000000010000000L010000000001
1000000000000000001L100000000001
100000000000001D001L001110011101
1000000000000111111L000111011001
1000000000000111111L000000000001
1000000000001111111L000000000001
1000000000011111100L000000011001
11111001111111111000001110011101
11111111111111111111111000000111
11111111111111111111110000000011
10000000000000000000000000000001
1111011111100L000000000010000001
1101011111111L110000100000000001
1000000011111L110000101110000111
1000000001111L110000001100000111
1000000000011L110000000000000001
1011000000001L110110000001100001
1110000001100L000110000000001001
11111100011111111111111111111111
10111100001111000011100000011111
100010000110000000L0001111001111
100000000001011111L0100000000001
10L000000001000000L0100011111001
10L111110001001110L0000000000001
10L000010001000000L0111100001001
10L011011000000000L1111110011001
10L1110011000E000001100100111001
11111111110111111100000000000001
11000111111111111111111111111111
11111111111111111111111111111111
