11111111111111111111111111111111
11111111111111111111111111111111
10001110000000000000000000000011
1000000011000L000000000010000001
1000000111111L110000111111100001
1000000000011L110000111110000111
1000000000011L110000001100001111
1000011001011L110000000000000001
100001D001001L110110000001100001
1111111111100L000110001000000001
11111111111111111111111000000111
11111111111111111111100000000001
11111111111000000000100000000001
11111111111000100000000000000001
11111111111111111000011000000001
11111011111111100001111L00000001
11110000011011000011111L11111101
11110000010000000000000L00000101
11110000000000011000010L11110011
11100000000010000000010L00000011
11111111111110000001111111111111
11111111111000000000000000011111
10000000000000000000001111001111
10000000000000000000000000000001
10000000000001001111000011111001
10000000000001001111000000000001
10000000000001001111011100001001
100000000000E1101111011110011001
10000000000111000000000100111001
11111001111111111111000000000001
11111111111111111111111111111111
11111111111111111111111111111111
