11111111111111111111111111111111
11111111111111011111011111111111
11000001101111000100000000000011
11000001101000000000000010000001
11110001101000000000011111100001
11000001111000000000011110000111
11000000111000000000001100001111
10000000000000011001000000000001
1000000000000001D001000001100001
10001111001011111111001000000001
11111111111111111111111000000111
11111111111111111111101111000011
11111111111000000000000010000111
11111111111111011111100000000001
1111111111110101111110L000000001
1111101111100000001110L111110001
1111000001100000000110L000010001
1111000001000000000000L011011001
1111000000001100000000L111001101
11100000000110000001111111111101
11111111111111110001110001111111
11111111111011110000100000000001
10000000000000100001100000000001
10000000000000000000000000000001
100000000000L0000000000100111101
100000000000L1111100000100111101
100000000000L0000100000100111101
100000000000L011011000E110111101
100000000000L1110011011100000001
11111001111111111111011111111101
11111111111100011111111111111111
11111111111111111111111111111111
