11111111111111111111111111111111
11111111111111111111111111111111
10000000000111000000000000000011
10000000000110000000000010000001
1000000000011000LD11111111100001
1000000000000000L111111110000111
1000000000000000L111101100001111
1000000000001100L001100000000001
10000000000111111111100001100001
11111001111000111000101000000001
11111111111111111111111000000111
11111111111000000111111000000001
10000000000001100011110000000001
11110111111000000000L11000001111
11010111111000000011L00000000001
10000000111011110011L00000000L01
10000000011000000011L01111111L01
10000000000000000011L01000111L01
10110000000000011111L11000110L01
11100000011111000000L10000000011
11111100011111111111111111111111
11110000011111111111111111111111
10011000010000000000100000000001
10001100000000100000000L00000001
10100001110111111000111L11000011
10111111110111100001111L11000011
10011000000011000011111L11000001
10000000000000001000011L11000001
10001100100000001000001L11011001
100011E1100011111100000L00011001
11111111111111111111111111111111
11111111111111111111111111111111
