11111111111111111111111111111111
11111111111000000111111100000001
10000000000001100011111100100001
10111001110000000000L10001111001
10111111000000000011L10000000001
10111110000011110011L10000010111
10010000000000000011L00000L10D11
10100000000000000011L11111L11111
10101100000000011111L00011L11111
10001000001111000000L00000L00111
11111000001111111111111111111111
10000000000000000111111111111111
10000000000011110011100000000001
10000000000000000000001110011101
11100000000000111110001111110001
111L0000000000000000001111100001
111L1111110111000010000100000001
100L0000010111100110001000000001
110L1111001001001110001011000001
110L0000001000000000000010000011
11111111111111111111111110000011
11111111111001100111000000000001
10000000000000000010000000000001
10000000000111111011100000000001
10000000000010000000011000000001
10000000000000001111111L00000001
10000000000000000000011L11111101
10000000000000010000000L00000101
10000000000000110000010L11110011
111110011110011111E0110L00000011
11111111111111111111111111111111
11111111111111111111111111111111
