11111111111111111111111111111111
11111111111111111111111111111111
1000111000000000000010L010000001
1000000011000010000001L110000001
1000000111111111100011L000000001
1000000000011110000110L000000001
1000000000001100001110L000000001
1000011001000000100000L000010001
100001D0010000001000011100011111
11111111111011111100010000000011
11111111111111111111111100000111
11111111111000000111101111000011
10000000001011110011100010000111
10001000000000000000000000000001
1111111000000011111000L000000001
1111100001100000000000L111110001
1011000011111100001000L000010001
1000000000011110011000L011011001
1000011000000100111000L111001101
10100000000000000000011111111101
11100000011111111111110001111111
11110000111000000111111111111111
10000000L00001100011100000000011
11011111L01000000000L00010000001
11000000L01000000011L11111100011
11001110L00011110011L11110000111
11000000L01000000011L01100001111
10000000L11000000011L00000100001
100E0000011000011111L00000100001
11111111000111000000L01111110001
11111111111111111111111111111111
11111111111111111111111111111111
