11111111111111111111111111111111
11111111111000000111111111111111
1000000000100110001110000000L001
10001000000000000000L1011111L011
11111110000000000011L1000000L011
11111000011011110011L1001110L001
10110000111000000011L1000000L011
10000000000000000011L0000000L111
10000110000000011111L000000D0111
10100000000111000000L11111110001
11100000011111111111111111111111
11000000001000000111111111111111
10000000001001100011100000000011
10011111000000000000L00010000001
1000000L000000000011L11111100001
1000000L111011110011L11110000111
1110000L111000000011L01100001111
1111000L000000000011L00000000001
10000001000000011111L00001100001
10111011100111000000L01000000001
11111111111111111111111000000111
11111111111000000000010000000011
10000000000000000000000000000001
10000000000000000000000010000001
10000000000001001111000000000001
10000000000001001111001110000111
10000000000001001111001100000111
100000000000E1101111000000000001
10000000000111000000000001100001
11111001111111111111000000001001
11111111111111111111111111111111
11111111111111111111111111111111
