11111111111111111111111111111111
11111111111000000111111100000001
11000000000011110011111100100001
10000000000000000000010001111001
10111001110000111110010000000001
10011101100000000000010000010111
10000000000111000010000000L10D11
10000000000111100110011111L11111
10000001100001001110000011L11111
10111001110000000000000000L00111
11100000011111111111111111111111
11000000001111111111111111111111
10110000001000000000011111111111
101100L0000011100111011111111111
101111L0000011111100011111111111
100000L0001011111000011111011111
100111L0001001000000011000001111
100000L0000010000000001000001111
100000L1110010110000000000001111
100000L1000000100000100000000111
11111111111111100000111111111111
11111111111001100111011111111111
10000000000000000010000000000001
10000000000111111011100L00000001
10000000000010000000011L11000011
10000000000000001111111L11000011
10000000000000000000011L11000001
10000000000000010000011L11000001
10000000000000110000001L11011001
111110011110011111E0100L00011001
11111111111111111111111111111111
11111111111111111111111111111111
