11111111111111111111111111111111
11111111111111000000011111111111
10L01000000111001000000000000001
11L11000000100011110011000000111
11L00000000100000000011101010111
10L00000000100000101111111111111
10L0000000000000L10D111010100111
10L0000100011111L111100000000101
1111000111100011L111100010000111
1100000000100000L001100111110001
11110000011111111111111111111111
11000000001111111111111111111111
10000000001000000000111111111111
10011111000000100000011111111111
1000000L000111111000011111111111
1000000L111111100001111111011111
1110000L111011000011111000001111
1111000L000000000000001000001111
10000001000000011000000000001111
10111011100010000000000000000111
11111111111110000001111111111111
10000000011000000000011111111111
10111111101000000000000000000001
10001000000000000000000000000001
10000000000110000000000000000001
1000000000011L000000000000000001
1011001110011L111111000000000001
1000000000000L000001000000000001
1000110110010L111100100000000001
100010E110010L000000111110011111
11111111111111111111111111111111
11111111111111111111111111111111
