11111111111111111111111111111111
11111111111111111111111111111111
1000000000010000000L010000000001
1000000000000000001L100000000001
100000000000001D001L001110011101
1000000000000111111L000111011001
1000000000000111111L000000000001
1000000000001111111L000000000001
1000000000011111100L000000011001
11111001111111111000001110011101
11111111111111111111111000000111
11111111111000000111100000000001
10000000001001100011100000000001
10001000000000000000L00000000001
11111110000000000011L11000000001
11111000011011110011L11L00000001
10110000111000000011L11L11111101
10000000000000000011L00L00000101
10000110000000011111L10L11110011
10100000000111000000L10L00000011
11100000011111111111111111111111
10111100001000000111100110011101
10001000011001100011100000001001
10000000000000000000L11111101111
10L00000000000000011L01000000001
10L11111000011110011L00000111111
10L00001000000000011L00000000001
10L01101100000000011L00001000001
10L11100110000011111L00011000001
11111111110111000000L0011111E011
11000111111111111111111111111111
11111111111111111111111111111111
