11111111111111111111111111111111
11110111110111000011111111111111
11110001000110000001000000000011
10000000000010000000000010000001
1000000000000L0000L0011111100001
1000000000000L1111L0011110000111
1000000000000L0000L0001100001111
1000011001000L1111L0100000000001
100001D001000L1111L0100001100001
1011111111010L1110L0001000000001
11111111111111111111111000000111
11111111111111111111101111000011
11000000000L00000000000010000111
10000000000L11111110000000000001
10111001110L0000000000L000000001
10011101100L0000011000L111110001
10000000000L0000011100L000010001
10000000000L0001000000L011011001
10000001100L1101000000L111001101
10111001110111111000011111111101
11100000011111111111110001111111
10000000000000000111111100000111
10000000000011110011100110000101
10000000000000000000000011000001
11100000000000111110001000011101
111L0000000000000000001111111101
111L1111110111000010000110000001
100L0000010111100110000000000001
110L1111001001001110000011001001
110L0000001000000000000011E11001
11111111111111111111111111111111
11111111111111111111111111111111
