11111111111111111111111111111111
11111111111111111111111111111111
100000000000000000L0000000000001
100000000001011111L0101110011101
100000000001000000L0101111110001
100000000001001110L0001111100001
100000000001000000L0100100000001
100000000000000000L1101000000001
10000000000000000D01101011000001
11111001111111111100000010000011
11111111111111111111111110000011
11111111111111111111110000000011
11000000000000000000101100000011
10000000000000100000001100L00001
10111001110111111000101111L00001
10011101100111100001100000L00011
10000000000011000011100111L00011
10000000000000001000000000L00001
10000001100000001000000000L11101
10111001110011111100000000L10001
11100000011111111111111111111111
11000000001000000001111111111111
10000000001011111110111111111111
10011111000000100000011111111111
1000000L000000000000011111111111
1000000L111000000000011111011111
1110000L111011001110011000001111
1111000L000000000000001000001111
10000001000000110110000000001111
1011101110000010E110000000000111
11111111111111111111111111111111
11111111111111111111111111111111
