1.....L.....L..................1
1.....L.....L..................1
1.....L.....L..................1
1.....L.....L..................1
1.....L.....L..................1
1.....L.....L..D...............1
1.....L.....L111.........1111..1
1.....L.....L..................1
1.....L.....L..................1
1.....L.....L..................1
1.....L..11111111..............1
1.....L........................1
1.....11.......................1
1...................111.11111111
1..............................1
1..............................1
1..............................1
1..............................1
1..............................1
1..............................1
1....11111111......1111111111..1
1.......111111.........111111111
1..............................1
1..............................1
1.....................11111111.1
1..............................1
1.....................1111111..1
1..............................1
1..............................1
1................E.............1
11111111111111111111111111111111
11111111111111111111111111111111
