1..............................1
1....111....111....11111.......1
111111111......................1
1..............................1
1..............................1
1.111..1111....................1
1........111111111.............1
1..11...11.......11............1
1..............................1
1..............................1
1........D.....................1
111111111111...111.............1
11111111.....111111............1
1..............................1
1........11111111..............1
1...........11111111111........1
1..............................1
1.........11111111.............1
1.......111111111111...........1
1..............................1
1..............................1
1..............................1
1....1111111...................1
1..........11111111...1111.....1
1.......................1111...1
11111111.111111...1111111......1
1..11..........................1
1.............1111.............1
111111111......................1
1.............................E1
11111111111111111111111111111111
11111111111111111111111111111111
