1.............11111111.........1
1..............................1
1.....1111...........111111....1
111............1111111.........1
1.............111..............1
1.1111111.1111111...111111.....1
1..........L.111...............1
1..........L.L.................1
1..........L.L.................1
1..........L.L.................1
1..........L.L.................1
1.........1111111..............1
11111111.......................1
111111111111...................1
1...........111111111111E......1
1...........1111111..11111.....1
1.1111111......................1
1...111...........111111.......1
1.....L........................1
1.....L........................1
1.....L........................1
1.....L........................1
1...1111........11111.1111.....1
1......1111111..L.L............1
1......111......L.L......11111.1
1...............L.L............1
1...............L.L............1
1..........11111111...11111....1
1.11111........................1
1...D..........................1
11111111111111111111111111111111
11111111111111111111111111111111
