1...................111111.....1
1..............................1
1..............................1
1..........111111..111.........1
1..............................1
1...111111.....................1
1.111111.......................1
1.........1111.11111111........1
1............L.................1
1............L.................1
1........11..L.................1
1............L.................1
1......1111111.................1
1.......1111111........1111111.1
1.11111.............D..........1
1.............111111111111.....1
1..............................1
1..............................1
1..............................1
1..............................1
1...........1111111.111111.....1
1..11111111...1111.............1
1....LL........................1
1....LL........................1
1....LL........................1
1....LL..........1111111111111.1
1....LL........................1
1..111111......................1
1..............11111111........1
1.......E......................1
11111111111111111111111111111111
11111111111111111111111111111111
