1..............................1
1..............................1
1..11111111111.................1
1..............................1
1.........1111111..............1
1..........E...................1
1.....1111111...........1111...1
1.1111111111..............L....1
1.........................L....1
1.........................L....1
1.........................L....1
1.........................L....1
1.........................L....1
1........11111.....1111111111111
1........................L.....1
1........................L.....1
1........................L.....1
1........................L.....1
1....1111...........111111111111
1..............................1
1.....................D........1
1111..11..............111111...1
1..............................1
1..............................1
1..............................1
1..............................1
1..............................1
1..............................1
1..............................1
1..............................1
11111111111111111111111111111111
11111111111111111111111111111111
