1.....11111.1111111..11111111..1
1............1111111.111111111.1
1.........11111................1
1..............................1
1..............................1
1.......1111111..111...........1
1D..........11111L......111....1
1111.............L.............1
1................L.............1
1................L.............1
1...........1111111............1
1.1111.....11111111....11111...1
1.......11111111...............1
1..............................1
1.......................1111...1
1..............................1
1.....111....1111....111.......1
1.11111111111..................1
111111111......................1
1..1111111...1111111...........1
1........111111................1
1..............................1
1..............................1
1..............................1
1..........1111................1
1..............................1
1....1111111.11111.............1
1...1111111..1111111...........1
1.....11....11111111..11.......1
1.......................E......1
11111111111111111111111111111111
11111111111111111111111111111111
