1..............................1
1..............................1
1..............................1
1..............................1
1................11............1
1..............................1
1..............................1
1..............................1
1..............................1
1..............................1
1..............................1
1..............................1
1..............................1
1..............................1
1..............................1
1..............................1
1..............................1
1..............................1
1..............................1
1..............................1
1..............................1
1..............................1
1..............................1
1..............................1
1..............................1
1..............................1
1..........1111......1111......1
1..............................1
1..............................1
1.D...........................E1
11111111111111111111111111111111
11111111111111111111111111111111
