11111111111111111111111111111111
11111111111111111111111111111111
10000000L00L00000000000000000001
11011111L01L11111110001110011101
11000000L01L00000000001111110001
11001110L00L00000110001111100001
11000000L01L00000111000100000001
10000000L11L00010000001000000001
1000000D011L11010000001011000001
11111111000111111000000010000011
11111111111111111111111110000011
11111111111111111111101111000011
10000000000L00000000000010000111
11110111111L11111110000000000001
11010111111L0000000000L000000001
10000000111L0000011000L111110001
10000000011L0000011100L000010001
10000000000L0001000000L011011001
10110000000L1101000000L111001101
11100000011111111000011111111101
11111100011111111111110001111111
10000000000111111111100000000001
10000000000000000000100000000001
10000000000000100000000000000001
11100000000111111000100100111101
111L0000000111100001100100111101
111L1111110011000011100100111101
100L000001000000100000E110111101
110L1111001000001000011100000001
110L0000001011111100011111111101
11111111111111111111111111111111
11111111111111111111111111111111
