11111111111111111111111111111111
11111111111111111111111100000001
10000000000000000000011100100001
1111011111100L000000010001111001
1101011111111L110000110000000001
1000000011111L110000110000010111
1000000001111L110000000000L10D11
1000000000011L110000011111L11111
1011000000001L110110000011L11111
1110000001100L000110000000L00111
11111100011111111111111111111111
11100000000000000111111111111111
11000000000001100011100000000011
11100000111000000000L00010000001
10000000000000000011L11111100001
100000000L0011110011L11110000111
101111111L0000000011L01100001111
101000111L0000000011L00000000001
111000110L0000011111L00001100001
11000000001111000000L01000000001
11111111111111111111111000000111
10000001111001100111001111000011
10011000111000000010000010000111
1000000000L111111011100000000001
1000000011L01000000000L000000001
1011110011L00000111110L111110001
1000000011L00000000000L000010001
1000000011L00001000000L011011001
1000011111L00011000000L111001101
1111000000L0011111E0111111111101
11111111111111111111110001111111
11111111111111111111111111111111
