11111111111111111111111111111111
11111111111111111111111111111111
10000.01L10L000000.0000000010011
11011111L01L11111111001110011101
11000101L01L00010000.01111.1.001
11111111L01L0.000110001111100001
110.00.0L01L00000111000100000001
110.0110010111100111000000.00001
100011D0010001101110000001100001
101111.111100000000001100.000001
1111111111111.111111111100000111
11111111111111111111111000000001
1111111111.000000000010000000001
1111.111111011101111011.00001111
11111111111011111110000010001001
11111.11111111111000000100000L01
111110000.1001100000001111111L01
11110100010010000000001100111L01
111110.0000010110000011000110L11
11100001.0000.1.00001100.0110011
11.1111111111110.010111111111.11
111111111111001100001111.0111111
10000010.011000111001000000.L001
10100000000001111100..0111111011
100010010000000.0L000100.1.0L011
10000000..0.00000L11110011101001
10000000011111100L.111000000L011
10010000000.11000L.000000000L1.1
10000000100010000100100E00000111
11111001111011101110.11111110.01
11111111111111111111111111111111
11111111111111111111111111111111
