11111111111111111111111111111111
11111111111111111111111111111111
10000000L00000000000100000000011
11011111L01000100000000010000001
11000000L01111111000111111100001
11001110L00111100001111110000111
11000000L01011000011101100001111
10000000L11000001000000000000001
1000000D011000001000000001100001
11111111000011111100001000000001
11111111111111111111111000000111
11111111111111111111110000000011
11000000000000000000101100000011
10000000000000100000001100L00001
10111001110111111000101111L00001
10011101100111100001100000L00011
10000000000011000011100111L00011
10000000000000001000000000L00001
10000001100000001000000000L11101
10111001110011111100000000L10001
11100000011111111111111111111111
10000000000000000111111111111111
10000000000011110011100000000001
10000000000000000000000000000001
10010011110000111110000000000001
10010011110000000000000000000001
10010011110111000010000000000001
10E11011110111100110000000000001
11110000000001001110000000000001
11111111110000000000011110011111
11111111111111111111111111111111
11111111111111111111111111111111
