11111111111111111111111111111111
11111111111111000011111111111111
1000L000000100000001010000000E01
1111011110100000000000100000LL11
1101011000000L0000000000E0L01L11
111000000110011111L00001101111L1
1010000011100LL000L0000111L11111
1000000000010L1111L0L01111100101
1000001000100L111100111111111100
10100000001100111100000011100001
11110110011111111111111111111111
10111000101111111111011111111111
11100010100000100000000000000001
111111L1111L11100010000101000001
001110L1001000000010111111100001
111000L00101101000L0010110000111
10111111100000000000001100001111
101100111100000010L0000000000001
1110D011011L000000L0000001100001
11000000001110110001001000000001
10111111111111110101111100000111
11111111111000000101101000000011
10000000000000101110D11100000011
10000000000100100000001000000001
10000000000000000011L00001111001
1000000000000000001L100000110001
10000000000011000111001000100001
100000000000E1000000001010111L01
10000000000000010100011100110101
11111001111000111100010000000101
11111111111111111111111111111111
11111111111111111111111111111111