11111111111111111111111111111111
11111111111000000111111111111111
10001000000111100011100000000001
10000000001000000001L00010010001
10000001111000000011L01110010001
100000000000L1010011000111010001
10000000000010000011L00000000001
10000110010010100011L00000000001
100001D0100001L11111100000011001
11111011110L10000000001110010001
11111111111111111111111000000111
11111111111000100111110000000001
10000000001L11100011100000000001
1000100000000000000L011100100001
11101110000000000011000000000001
11111000011001100010000000L10L11
10110000111000001001011001100011
10000000000000100000011000100001
10110110000000011000L00100L10D01
10100100000111011000000000100111
11100000011111111111111111111111
10000000011111000010111111111111
10100000001110000000000000001111
100000000001000010000000000L1011
1000000000011L101010001000000011
10000000L0000L1111L1000010000111
1111111110100LL011L0001000001101
110LL01010000L1111L0000000000001
110000010L100L1111001000E0001001
100L000000000D111000000111010101
11111111111111111111011111111111
11111111111111111111111111111111