11111111111111111111111111111111
11111111111000000111111111111111
10000000000111100011100000000001
10000000001000000001L00000000001
10000001111000000011L01110010001
10000000000011010011000111010001
10000000000010000011L00000000001
10000110010010100011L00000000001
100001D0100001L11111100000011001
11111011110L10000000001110010001
11111111111111111111111000000111
11111111111000100111110000000001
10000000001L11100011100000000001
1000100010000000000L011100100001
11101110000000000011000000000001
11111000011001100010000000L10L11
10110000111000001001011001100L11
10000000000000100000011100000D01
10100110000000011000000100L10D01
10100100000111011000000010100111
11100000011111111111111111111111
10000000011111000010111111111111
10100000001110000000000001001111
100000000001000010100000000L1011
1000000000011L101010000000000011
10000000L0000L1111L1000010000111
1111111110100LL011L0001000000001
110L001010000L1111L0000000000001
110000010L100L111100100000001001
1000000000000D111000000111010101
11111111111111111111011111111111
11111111111111111111111111111111