11111111111111111111111111111111
11111111111011111111111111111111
10000000000011000010110000000001
10000000000111101000100000000101
1000000001011000LD11L00010001101
1000000000000000011LL00100000001
10000000000111000011L00000000001
1000000000111110001L100000100001
10000000000111011111L00000000001
11111001111010000000L11110011101
11011111111100111111111001010111
1111111111100000011111000L000011
10001000000001110E0111110L000001
10001000011000000000000100011111
11111111000000100010001011L0D011
11111100000011000000010011011001
1011010001111E0000100110111L1011
10000000000011101100000010L11101
1010111100100L101110000L10011101
10000000000001110100110011000111
L1101000001111111E11111111111111
1111000000D000000111110100011111
1L0100000011111000E0100000001001
011101011L0000000000011111111111
10010D01000L00111011000000000011
10L01111100000000011010000111101
100000010100110000110000000E1001
1L110L101L0101D00110010000000001
11111100000001001110LL1101000001
0111111E00000E00000L011110111111
10111111111111111111110111111111
1111110111111111111111111L111111