11111111111111111111111111111111
11111111111000000111111111111111
10001000000111100011100000000001
10000000001000000001L00000000001
10000001111000000011L01110011001
100000000000L0010011000111010001
10000000000010000011L00100000001
10000111010000100011L00000000001
100001D0100001L11111100000011001
11111011110L10000000001110010001
11111111111111111111111000000111
11111111111000100111010000000001
10000000001L11100011100000000001
1000100010000000000L011100100001
11101110000000000011000000000001
111110000110011000100D0000L10L11
10110000111000001001011001100L11
10000000000000100000011100000D01
10100110000000011000000100L10101
10100100000111011000000010100111
11100000011111111111111111111111
10000000111111000010111111111111
10100000001110000000000001001111
100000000001L00000000000000L1011
1000000000010L101010001000000011
10000000L0000L1111L1010010000111
1111111110100LL011L0001000001001
110L001011000L1111L0100000000001
110000010L100L111100100000001001
1000000000000D111100000111010101
11111111111111111111011111111111
11111111111111111111111111111111