11111111111111111111111111111111
11111111111011111111111111111111
10000000000011000010110000000001
10000000000111101000100000000101
1000000001011L00LD11L00010001101
1000000000000000011LL00100000001
10000000000111000011L00000000001
1000000000111110011L100000100001
10010000000111011111L00000000001
11111001111010000000L11110011101
11011111111100111111111000010111
1111111111100000011111000L000011
10001000001001110E0111110L000001
110010000110000000000001000111E1
11111110000000100010001011L0D011
11111100010011000000010111011001
E011010001111E0000100110111L1011
10000000000011101100000010L11101
1010111100100D1011100L0L10011101
10100000000001100100110001000111
11100000001111111E11111111111111
1111000000D000000111110100011111
1L0100000011111000E1100000001001
011101011L0000000000011111111111
10010D01000L00111011000000000011
10L01111100000000011010000111101
100000010100110000110000000E1001
1L110L101L0101D00110010000000001
11111100000001001111LL1101000001
0111111E000E0E00000L011110111111
10111111111111111111110111111111
11111101111111111111111111111111